coach_name,last_year_bonus,max_bonus,other_pay,school_pay,total_pay,year,school,conference
Matt Luke,0,0,0,1160000,1160000,2017,Ole Miss,SEC
Hugh Freeze,300000,1225000,3500,4700000,4703500,2016,Ole Miss,SEC
Hugh Freeze,125000,975000,10000,4300000,4310000,2015,Ole Miss,SEC
Hugh Freeze,0,825000,18000,3000000,3018000,2014,Ole Miss,SEC
Hugh Freeze,0,1575000,5500,2000000,2005500,2013,Ole Miss,SEC
Hugh Freeze,0,1475000,5500,1500000,1505500,2012,Ole Miss,SEC
Houston Nutt,0,715000,15500,2756250,2771750,2011,Ole Miss,SEC
Houston Nutt,0,0,9000,2500000,2509000,2010,Ole Miss,SEC
Houston Nutt,0,715000,2309000,200000,2509000,2009,Ole Miss,SEC
Ed Orgeron,0,0,700000,200000,900000,2007,Ole Miss,SEC
Ed Orgeron,0,0,5000,900000,905000,2006,Ole Miss,SEC
Mark Dantonio,0,650000,10000,4380492,4390492,2017,Michigan State,Big Ten
Mark Dantonio,475000,650000,0,4300000,4300000,2016,Michigan State,Big Ten
Mark Dantonio,250000,650000,0,3671520,3671520,2015,Michigan State,Big Ten
Mark Dantonio,0,650000,24300,5611845,5636145,2014,Michigan State,Big Ten
Mark Dantonio,0,650000,0,1959744,1959744,2013,Michigan State,Big Ten
Mark Dantonio,0,650000,0,1934250,1934250,2012,Michigan State,Big Ten
Mark Dantonio,0,650000,0,1918000,1918000,2011,Michigan State,Big Ten
Mark Dantonio,0,660000,0,1796700,1796700,2010,Michigan State,Big Ten
Mark Dantonio,0,725000,984000,827260,1811260,2009,Michigan State,Big Ten
Mark Dantonio,0,650000,550000,600000,1150000,2007,Michigan State,Big Ten
John L. Smith,0,375000,900000,645834,1545834,2006,Michigan State,Big Ten
Craig Bohl,213750,450000,0,1412000,1412000,2017,Wyoming,Mt. West
Craig Bohl,105000,330000,0,909000,909000,2016,Wyoming,Mt. West
Craig Bohl,120000,330000,0,882000,882000,2015,Wyoming,Mt. West
Craig Bohl,0,330000,0,832000,832000,2014,Wyoming,Mt. West
Dave Christensen,0,25000,0,1200000,1200000,2013,Wyoming,Mt. West
Dave Christensen,0,25000,0,1200000,1200000,2012,Wyoming,Mt. West
Dave Christensen,0,260000,0,843376,843376,2011,Wyoming,Mt. West
Dave Christensen,0,260000,0,861000,861000,2010,Wyoming,Mt. West
Dave Christensen,0,470970,210000,391730,601730,2009,Wyoming,Mt. West
Joe Glenn,0,37527,78960,472349,551309,2007,Wyoming,Mt. West
Joe Glenn,0,37527,75000,430100,505100,2006,Wyoming,Mt. West
P.J. Fleck,0,900000,0,3500000,3500000,2017,Minnesota,Big Ten
Tracy Claeys,157942,1250000,0,1400000,1400000,2016,Minnesota,Big Ten
Jerry Kill,375000,1150000,0,2500000,2500000,2015,Minnesota,Big Ten
Jerry Kill,0,1150000,0,2100000,2100000,2014,Minnesota,Big Ten
Jerry Kill,0,875000,0,1200000,1200000,2013,Minnesota,Big Ten
Jerry Kill,0,875000,0,1200000,1200000,2012,Minnesota,Big Ten
Jerry Kill,0,875000,0,1700000,1700000,2011,Minnesota,Big Ten
Tim Brewster,0,1050000,0,808000,808000,2010,Minnesota,Big Ten
Tim Brewster,0,700000,400000,600000,1000000,2009,Minnesota,Big Ten
Tim Brewster,0,650000,400000,600000,1000000,2007,Minnesota,Big Ten
Glen Mason,0,750000,450000,760000,1210000,2006,Minnesota,Big Ten
Shawn Elliott,0,220000,0,565000,565000,2017,Georgia State,Sun Belt
Trent Miles,56000,362500,2000,537405,539405,2016,Georgia State,Sun Belt
Trent Miles,9500,362500,4000,523500,527500,2015,Georgia State,Sun Belt
Trent Miles,0,381500,0,510000,510000,2014,Georgia State,Sun Belt
Trent Miles,0,304500,0,510000,510000,2013,Georgia State,Sun Belt
Lovie Smith,75000,1000000,0,3000000,3000000,2017,Illinois,Big Ten
Lovie Smith,0,1000000,0,1809179,1809179,2016,Illinois,Big Ten
Bill Cubit,0,51500,1010,915000,916010,2015,Illinois,Big Ten
Tim Beckman,0,80000,250,1950000,1950250,2014,Illinois,Big Ten
Tim Beckman,0,80000,0,1700000,1700000,2013,Illinois,Big Ten
Tim Beckman,0,80000,0,1600000,1600000,2012,Illinois,Big Ten
Ron Zook,0,65650,3500,1750000,1753500,2011,Illinois,Big Ten
Ron Zook,0,52650,3500,1505000,1508500,2010,Illinois,Big Ten
Ron Zook,0,52650,900000,605000,1505000,2009,Illinois,Big Ten
Ron Zook,0,26650,750000,305000,1055000,2007,Illinois,Big Ten
Ron Zook,0,28600,711750,530000,1241750,2006,Illinois,Big Ten
Jason Candle,57500,615000,950,700000,700950,2017,Toledo,MAC
Jason Candle,0,602500,0,675000,675000,2016,Toledo,MAC
Matt Campbell,137500,450000,1450,495000,496450,2015,Toledo,MAC
Matt Campbell,0,450000,12037,470500,482537,2014,Toledo,MAC
Matt Campbell,0,400000,2500,455000,457500,2013,Toledo,MAC
Matt Campbell,0,305000,450,360000,360450,2012,Toledo,MAC
Tim Beckman,0,280000,2540,409000,411540,2011,Toledo,MAC
Tim Beckman,0,256000,0,370000,370000,2010,Toledo,MAC
Tim Beckman,0,255500,125000,235000,360000,2009,Toledo,MAC
Tom Amstutz,0,227000,118300,195000,313300,2007,Toledo,MAC
Tom Amstutz,0,212000,191400,185000,376400,2006,Toledo,MAC
Tom Allen,0,1441668,0,1830000,1830000,2017,Indiana,Big Ten
Kevin Wilson,175000,1130000,0,2320000,2320000,2016,Indiana,Big Ten
Kevin Wilson,25000,1130000,0,1312277,1312277,2015,Indiana,Big Ten
Kevin Wilson,0,1130000,0,1301644,1301644,2014,Indiana,Big Ten
Kevin Wilson,0,780000,0,1291220,1291220,2013,Indiana,Big Ten
Kevin Wilson,0,830000,0,1260000,1260000,2012,Indiana,Big Ten
Kevin Wilson,0,830000,0,1260000,1260000,2011,Indiana,Big Ten
Bill Lynch,0,450000,0,650000,650000,2010,Indiana,Big Ten
Bill Lynch,0,450000,350000,308750,658750,2009,Indiana,Big Ten
Bill Lynch,0,200000,100000,193297,293297,2007,Indiana,Big Ten
Terry Hoeppner,0,200000,300000,300000,600000,2006,Indiana,Big Ten
Brent Brennan,0,210000,0,581916,581916,2017,San Jose State,Mt. West
Ron Caragher,10000,195000,0,546745,546745,2016,San Jose State,Mt. West
Ron Caragher,5000,195000,30,540745,540775,2015,San Jose State,Mt. West
Ron Caragher,0,195000,0,525000,525000,2014,San Jose State,Mt. West
Ron Caragher,0,195000,0,525000,525000,2013,San Jose State,Mt. West
Mike MacIntyre,0,300835,10000,401820,411820,2012,San Jose State,Mt. West
Mike MacIntyre,0,300835,10000,401820,411820,2011,San Jose State,Mt. West
Mike MacIntyre,0,300835,2000,401820,403820,2010,San Jose State,Mt. West
Dick Tomey,0,73335,257816,200004,457820,2009,San Jose State,Mt. West
Dick Tomey,0,49167,206000,245004,451004,2007,San Jose State,Mt. West
Dick Tomey,0,88450,135400,206700,342100,2006,San Jose State,Mt. West
Matt Viator,0,50000,0,390000,390000,2017,Louisiana-Monroe,Sun Belt
Matt Viator,0,50000,0,390000,390000,2016,Louisiana-Monroe,Sun Belt
Todd Berry,0,47500,600,360000,360600,2015,Louisiana-Monroe,Sun Belt
Todd Berry,0,47500,1250,357000,358250,2014,Louisiana-Monroe,Sun Belt
Todd Berry,0,42500,0,288268,288268,2013,Louisiana-Monroe,Sun Belt
Todd Berry,0,62500,0,250000,250000,2012,Louisiana-Monroe,Sun Belt
Todd Berry,0,62500,0,225000,225000,2011,Louisiana-Monroe,Sun Belt
Todd Berry,0,62500,0,215000,215000,2010,Louisiana-Monroe,Sun Belt
Charlie Weatherbie,0,30000,0,160000,160000,2009,Louisiana-Monroe,Sun Belt
Charlie Weatherbie,0,30000,50000,155000,205000,2007,Louisiana-Monroe,Sun Belt
Charlie Weatherbie,0,0,5000,125000,130000,2006,Louisiana-Monroe,Sun Belt
Tom Herman,0,725000,0,5486316,5486316,2017,Texas,Big 12
Charlie Strong,0,1006000,130,5200000,5200130,2016,Texas,Big 12
Charlie Strong,25000,1003000,270,5100000,5100270,2015,Texas,Big 12
Charlie Strong,0,1000000,270,5000000,5000270,2014,Texas,Big 12
Mack Brown,0,850000,61250,5392500,5453750,2013,Texas,Big 12
Mack Brown,0,850000,61250,5292500,5353750,2012,Texas,Big 12
Mack Brown,0,850000,1000,5192500,5193500,2011,Texas,Big 12
Mack Brown,0,850000,61500,5100000,5161500,2010,Texas,Big 12
Mack Brown,0,850000,1520500,1540000,3060500,2009,Texas,Big 12
Mack Brown,0,325000,1460000,1291000,2751000,2007,Texas,Big 12
Mack Brown,0,325000,1580000,1084000,2664000,2006,Texas,Big 12
John Bonamego,35500,330000,0,545640,545640,2017,Central Michigan,MAC
John Bonamego,43500,320000,300,545640,545940,2016,Central Michigan,MAC
John Bonamego,0,330000,0,533500,533500,2015,Central Michigan,MAC
Dan Enos,0,305000,0,360000,360000,2014,Central Michigan,MAC
Dan Enos,0,224000,600,360000,360600,2013,Central Michigan,MAC
Dan Enos,0,133000,600,325000,325600,2012,Central Michigan,MAC
Dan Enos,0,125500,600,325000,325600,2011,Central Michigan,MAC
Dan Enos,0,125500,0,350000,350000,2010,Central Michigan,MAC
Butch Jones,0,237500,30500,277950,308450,2009,Central Michigan,MAC
Butch Jones,0,140000,65000,200850,265850,2007,Central Michigan,MAC
Brian Kelly,0,14500,25500,159397,184897,2006,Central Michigan,MAC
Jay Hopson,15000,867500,0,500000,500000,2017,Southern Miss,C-USA
Jay Hopson,0,867500,0,500000,500000,2016,Southern Miss,C-USA
Todd Monken,15000,125000,0,700000,700000,2015,Southern Miss,C-USA
Todd Monken,0,125000,0,700000,700000,2014,Southern Miss,C-USA
Todd Monken,0,133333,1200,700000,701200,2013,Southern Miss,C-USA
Ellis Johnson,0,465000,0,790000,790000,2012,Southern Miss,C-USA
Larry Fedora,0,387500,19500,685000,704500,2011,Southern Miss,C-USA
Larry Fedora,0,165000,19500,685000,704500,2010,Southern Miss,C-USA
Larry Fedora,0,160000,394500,341602,736102,2009,Southern Miss,C-USA
Jeff Bower,0,152000,159750,365233,524983,2007,Southern Miss,C-USA
Jeff Bower,0,274048,74750,275233,349983,2006,Southern Miss,C-USA
Rocky Long,198150,735000,2000,826304,828304,2017,San Diego State,Mt. West
Rocky Long,195000,655000,0,810632,810632,2016,San Diego State,Mt. West
Rocky Long,65000,655000,2000,806300,808300,2015,San Diego State,Mt. West
Rocky Long,0,855000,2000,800000,802000,2014,San Diego State,Mt. West
Rocky Long,0,855000,0,800000,800000,2013,San Diego State,Mt. West
Rocky Long,0,805000,2600,800000,802600,2012,San Diego State,Mt. West
Rocky Long,0,855000,1000,800000,801000,2011,San Diego State,Mt. West
Brady Hoke,0,700000,0,675000,675000,2010,San Diego State,Mt. West
Brady Hoke,0,900000,1800,675000,676800,2009,San Diego State,Mt. West
Chuck Long,0,125000,506000,210900,716900,2007,San Diego State,Mt. West
Chuck Long,0,300000,1500,700000,701500,2006,San Diego State,Mt. West
Philip Montgomery,0,0,0,1398038,1398038,2017,Tulsa,AAC
Philip Montgomery,0,0,0,0,0,2016,Tulsa,AAC
Philip Montgomery,0,0,0,0,0,2015,Tulsa,AAC
Bill Blankenship,0,0,0,759436,759436,2014,Tulsa,AAC
Bill Blankenship,0,0,0,619549,619549,2013,Tulsa,AAC
Bill Blankenship,0,0,0,0,0,2012,Tulsa,AAC
Bill Blankenship,0,0,0,0,0,2011,Tulsa,AAC
Todd Graham,0,0,0,804253,804253,2010,Tulsa,AAC
Todd Graham,0,0,0,769264,769264,2009,Tulsa,AAC
Todd Graham,0,0,0,0,0,2007,Tulsa,AAC
Steve Kragthorpe,0,0,0,438533,438533,2006,Tulsa,AAC
David Beaty,25000,1750000,0,1601109,1601109,2017,Kansas,Big 12
David Beaty,0,925000,0,801109,801109,2016,Kansas,Big 12
David Beaty,0,925000,0,801169,801169,2015,Kansas,Big 12
Charlie Weis,0,765000,0,2500000,2500000,2014,Kansas,Big 12
Charlie Weis,0,615000,3727,2500000,2503727,2013,Kansas,Big 12
Charlie Weis,0,615000,0,2500000,2500000,2012,Kansas,Big 12
Turner Gill,0,419158,1200,2100000,2101200,2011,Kansas,Big 12
Turner Gill,0,419158,1200,2100000,2101200,2010,Kansas,Big 12
Mark Mangino,0,675000,1773600,529900,2303500,2009,Kansas,Big 12
Mark Mangino,0,425000,1294040,229900,1523940,2007,Kansas,Big 12
Mark Mangino,0,425000,1288381,220000,1508381,2006,Kansas,Big 12
Jimbo Fisher,200000,1475000,0,5700000,5700000,2017,Florida State,ACC
Jimbo Fisher,100000,1475000,0,5250000,5250000,2016,Florida State,ACC
Jimbo Fisher,500000,1475000,0,5150000,5150000,2015,Florida State,ACC
Jimbo Fisher,0,1275000,0,3591667,3591667,2014,Florida State,ACC
Jimbo Fisher,0,675000,0,2750000,2750000,2013,Florida State,ACC
Jimbo Fisher,0,675000,0,2750000,2750000,2012,Florida State,ACC
Jimbo Fisher,0,725000,0,2750000,2750000,2011,Florida State,ACC
Jimbo Fisher,0,675000,3500,1800000,1803500,2010,Florida State,ACC
Bobby Bowden,0,727793,1753500,565875,2319375,2009,Florida State,ACC
Bobby Bowden,0,272578,1217000,478200,1695200,2007,Florida State,ACC
Bobby Bowden,0,272578,1339700,352200,1691900,2006,Florida State,ACC
Randy Edsall,0,650000,0,1000000,1000000,2017,Connecticut,AAC
Bob Diaco,33333,450000,0,1700000,1700000,2016,Connecticut,AAC
Bob Diaco,0,450000,0,1550000,1550000,2015,Connecticut,AAC
Bob Diaco,0,450000,0,1500000,1500000,2014,Connecticut,AAC
Paul Pasqualoni,0,116666,0,1700000,1700000,2013,Connecticut,AAC
Paul Pasqualoni,0,115625,0,1600000,1600000,2012,Connecticut,AAC
Paul Pasqualoni,0,114583,0,1500000,1500000,2011,Connecticut,AAC
Randy Edsall,0,114583,0,1550000,1550000,2010,Connecticut,AAC
Randy Edsall,0,113542,1125000,325000,1450000,2009,Connecticut,AAC
Randy Edsall,0,68751,645000,275000,920000,2007,Connecticut,AAC
Randy Edsall,0,0,595000,250000,845000,2006,Connecticut,AAC
Matt Wells,10000,730000,0,1050000,1050000,2017,Utah State,Mt. West
Matt Wells,60000,730000,0,800000,800000,2016,Utah State,Mt. West
Matt Wells,65000,770000,2900,750000,752900,2015,Utah State,Mt. West
Matt Wells,0,765000,1434,575000,576434,2014,Utah State,Mt. West
Matt Wells,0,735000,2500,500000,502500,2013,Utah State,Mt. West
Gary Andersen,0,150000,0,415000,415000,2012,Utah State,Mt. West
Gary Andersen,0,45000,2000,352400,354400,2011,Utah State,Mt. West
Gary Andersen,0,45000,2000,352400,354400,2010,Utah State,Mt. West
Gary Andersen,0,45000,50000,302400,352400,2009,Utah State,Mt. West
Brent Guy,0,26837,23500,226044,249544,2007,Utah State,Mt. West
Brent Guy,0,26200,23500,218400,241900,2006,Utah State,Mt. West
Dana Holgorsen,185000,750000,0,3505000,3505000,2017,West Virginia,Big 12
Dana Holgorsen,60000,600000,0,2980000,2980000,2016,West Virginia,Big 12
Dana Holgorsen,35000,600000,0,2880000,2880000,2015,West Virginia,Big 12
Dana Holgorsen,0,600000,0,3080000,3080000,2014,West Virginia,Big 12
Dana Holgorsen,0,600000,0,2630000,2630000,2013,West Virginia,Big 12
Dana Holgorsen,0,600000,0,2380000,2380000,2012,West Virginia,Big 12
Dana Holgorsen,0,600000,0,1490000,1490000,2011,West Virginia,Big 12
Bill Stewart,0,590000,30000,903000,933000,2010,West Virginia,Big 12
Bill Stewart,0,565000,603000,275000,878000,2009,West Virginia,Big 12
Rich Rodriguez,0,385000,600000,1203000,1803000,2007,West Virginia,Big 12
Rich Rodriguez,0,415000,850000,250000,1100000,2006,West Virginia,Big 12
Frank Wilson,17500,185000,0,1137500,1137500,2017,UTSA,C-USA
Frank Wilson,0,185000,0,835000,835000,2016,UTSA,C-USA
Larry Coker,0,255000,2150,425000,427150,2015,UTSA,C-USA
Larry Coker,0,230000,2150,400000,402150,2014,UTSA,C-USA
Larry Coker,0,30000,1150,350000,351150,2013,UTSA,C-USA
Larry Coker,0,30000,1150,350000,351150,2012,UTSA,C-USA
Mark Whipple,0,255000,250,472654,472904,2017,Massachusetts,Ind.
Mark Whipple,10000,295000,1250,467965,469215,2016,Massachusetts,Ind.
Mark Whipple,0,200000,6000,450000,456000,2015,Massachusetts,Ind.
Mark Whipple,0,200000,0,450000,450000,2014,Massachusetts,Ind.
Charley Molnar,0,162500,1200,417730,418930,2013,Massachusetts,Ind.
Charley Molnar,0,122500,0,400625,400625,2012,Massachusetts,Ind.
Willie Fritz,0,0,0,0,0,2017,Tulane,AAC
Willie Fritz,0,0,0,0,0,2016,Tulane,AAC
Curtis Johnson,0,0,0,926000,926000,2015,Tulane,AAC
Curtis Johnson,0,0,0,867000,867000,2014,Tulane,AAC
Curtis Johnson,0,0,0,0,0,2013,Tulane,AAC
Curtis Johnson,0,0,0,0,0,2012,Tulane,AAC
Bob Toledo,0,0,0,0,0,2011,Tulane,AAC
Bob Toledo,0,0,0,0,0,2010,Tulane,AAC
Bob Toledo,0,0,0,0,0,2009,Tulane,AAC
Bob Toledo,0,0,0,0,0,2007,Tulane,AAC
Chris Scelfo,0,0,0,0,0,2006,Tulane,AAC
Will Muschamp,125000,1075000,0,3100000,3100000,2017,South Carolina,SEC
Will Muschamp,0,1075000,2500,3000000,3002500,2016,South Carolina,SEC
Steve Spurrier,200000,1700000,28600,4000000,4028600,2015,South Carolina,SEC
Steve Spurrier,0,1700000,16900,4000000,4016900,2014,South Carolina,SEC
Steve Spurrier,0,1550000,22500,3300000,3322500,2013,South Carolina,SEC
Steve Spurrier,0,1550000,35000,3550000,3585000,2012,South Carolina,SEC
Steve Spurrier,0,1000000,28000,2800000,2828000,2011,South Carolina,SEC
Steve Spurrier,0,1000000,32500,2000000,2032500,2010,South Carolina,SEC
Steve Spurrier,0,900000,1524000,507500,2031500,2009,South Carolina,SEC
Steve Spurrier,0,800000,1515000,257500,1772500,2007,South Carolina,SEC
Steve Spurrier,0,700000,1042500,257500,1300000,2006,South Carolina,SEC
Barry Odom,162500,1025000,0,2350000,2350000,2017,Missouri,SEC
Barry Odom,0,1025000,0,2350000,2350000,2016,Missouri,SEC
Gary Pinkel,900000,725000,0,3768889,3768889,2015,Missouri,SEC
Gary Pinkel,0,1825000,0,3400000,3400000,2014,Missouri,SEC
Gary Pinkel,0,850000,200,2800000,2800200,2013,Missouri,SEC
Gary Pinkel,0,850000,0,2700000,2700000,2012,Missouri,SEC
Gary Pinkel,0,850000,0,2700000,2700000,2011,Missouri,SEC
Gary Pinkel,0,850000,0,2550000,2550000,2010,Missouri,SEC
Gary Pinkel,0,850000,1950000,575000,2525000,2009,Missouri,SEC
Gary Pinkel,0,473750,1045000,275000,1320000,2007,Missouri,SEC
Gary Pinkel,0,462499,700000,395000,1095000,2006,Missouri,SEC
Dabo Swinney,1525000,1000000,22200,8504600,8526800,2017,Clemson,ACC
Dabo Swinney,1100000,1725000,5200,4417500,4422700,2016,Clemson,ACC
Dabo Swinney,50000,1125000,5200,3300000,3305200,2015,Clemson,ACC
Dabo Swinney,0,1200000,25100,3150000,3175100,2014,Clemson,ACC
Dabo Swinney,0,775000,10000,2540024,2550024,2013,Clemson,ACC
Dabo Swinney,0,775000,10000,2040024,2050024,2012,Clemson,ACC
Dabo Swinney,0,775000,13000,1833333,1846333,2011,Clemson,ACC
Dabo Swinney,0,694792,18500,1750000,1768500,2010,Clemson,ACC
Dabo Swinney,0,875000,566850,250000,816850,2009,Clemson,ACC
Tommy Bowden,0,272278,934500,297332,1231832,2007,Clemson,ACC
Tommy Bowden,0,270252,925000,273028,1198028,2006,Clemson,ACC
Scott Satterfield,155000,270000,0,675000,675000,2017,Appalachian State,Sun Belt
Scott Satterfield,30000,290000,0,525000,525000,2016,Appalachian State,Sun Belt
Scott Satterfield,27500,165000,0,375000,375000,2015,Appalachian State,Sun Belt
Scott Satterfield,0,25000,0,225000,225000,2014,Appalachian State,Sun Belt
Joe Moglia,0,525000,0,400000,400000,2017,Coastal Carolina,Sun Belt
Brad Lambert,0,120000,0,625000,625000,2017,Charlotte,C-USA
Brad Lambert,0,120000,0,600000,600000,2016,Charlotte,C-USA
Brad Lambert,0,120000,0,600000,600000,2015,Charlotte,C-USA
Luke Fickell,0,625000,0,1900000,1900000,2017,Cincinnati,AAC
Tommy Tuberville,70000,565000,0,2200000,2200000,2016,Cincinnati,AAC
Tommy Tuberville,140000,540000,0,2200000,2200000,2015,Cincinnati,AAC
Tommy Tuberville,0,565000,0,2200000,2200000,2014,Cincinnati,AAC
Tommy Tuberville,0,465000,0,3143000,3143000,2013,Cincinnati,AAC
Butch Jones,0,330000,0,1769648,1769648,2012,Cincinnati,AAC
Butch Jones,0,330000,500,1393333,1393833,2011,Cincinnati,AAC
Butch Jones,0,320000,1500,1100000,1101500,2010,Cincinnati,AAC
Brian Kelly,0,400000,1047500,315000,1362500,2009,Cincinnati,AAC
Brian Kelly,0,380000,450000,385000,835000,2007,Cincinnati,AAC
Mark Dantonio,0,701667,225000,270000,495000,2006,Cincinnati,AAC
Dave Clawson,0,0,0,1827370,1827370,2017,Wake Forest,ACC
Dave Clawson,0,0,0,2113166,2113166,2016,Wake Forest,ACC
Dave Clawson,0,0,0,0,0,2015,Wake Forest,ACC
Dave Clawson,0,0,0,0,0,2014,Wake Forest,ACC
Jim Grobe,0,0,0,2251635,2251635,2013,Wake Forest,ACC
Jim Grobe,0,0,0,2254798,2254798,2012,Wake Forest,ACC
Jim Grobe,0,0,0,2275545,2275545,2011,Wake Forest,ACC
Jim Grobe,0,0,0,2939475,2939475,2010,Wake Forest,ACC
Jim Grobe,0,343000,1839127,333000,2172127,2009,Wake Forest,ACC
Jim Grobe,0,0,0,1021379,1021379,2007,Wake Forest,ACC
Jim Grobe,0,0,0,987843,987843,2006,Wake Forest,ACC
Lane Kiffin,0,350000,0,950000,950000,2017,Florida Atlantic,C-USA
Charlie Partridge,5000,100000,0,591250,591250,2016,Florida Atlantic,C-USA
Charlie Partridge,0,100000,500,525000,525500,2015,Florida Atlantic,C-USA
Charlie Partridge,0,100000,0,500000,500000,2014,Florida Atlantic,C-USA
Carl Pelini,0,317500,1100,496124,497224,2013,Florida Atlantic,C-USA
Carl Pelini,0,317500,0,450000,450000,2012,Florida Atlantic,C-USA
Howard Schnellenberger,0,115000,5500,400405,405905,2011,Florida Atlantic,C-USA
Howard Schnellenberger,0,115000,7500,400405,407905,2010,Florida Atlantic,C-USA
Howard Schnellenberger,0,115000,2000,381338,383338,2009,Florida Atlantic,C-USA
Howard Schnellenberger,0,0,1000,330163,331163,2007,Florida Atlantic,C-USA
Howard Schnellenberger,0,0,3000,350147,353147,2006,Florida Atlantic,C-USA
Chris Petersen,675000,1050000,2500,4125000,4127500,2017,Washington,Pac-12
Chris Petersen,150000,1175000,5847,3600000,3605847,2016,Washington,Pac-12
Chris Petersen,200000,1175000,2940,3400000,3402940,2015,Washington,Pac-12
Chris Petersen,0,1175000,0,3681720,3681720,2014,Washington,Pac-12
Steve Sarkisian,0,1525000,0,2575000,2575000,2013,Washington,Pac-12
Steve Sarkisian,0,1525000,0,2425000,2425000,2012,Washington,Pac-12
Steve Sarkisian,0,1075000,0,2250000,2250000,2011,Washington,Pac-12
Steve Sarkisian,0,1500000,0,1850004,1850004,2010,Washington,Pac-12
Steve Sarkisian,0,1500000,1383333,450000,1833333,2009,Washington,Pac-12
Tyrone Willingham,0,337500,812804,657472,1470276,2007,Washington,Pac-12
Tyrone Willingham,0,402500,750004,664768,1414772,2006,Washington,Pac-12
Neal Brown,80000,490000,0,800000,800000,2017,Troy,Sun Belt
Neal Brown,0,490000,0,660000,660000,2016,Troy,Sun Belt
Neal Brown,0,475000,0,660000,660000,2015,Troy,Sun Belt
Larry Blakeney,0,77500,0,518788,518788,2014,Troy,Sun Belt
Larry Blakeney,0,67500,1000,480000,481000,2013,Troy,Sun Belt
Larry Blakeney,0,75000,0,455000,455000,2012,Troy,Sun Belt
Larry Blakeney,0,75000,1000,380000,381000,2011,Troy,Sun Belt
Larry Blakeney,0,75000,1000,355000,356000,2010,Troy,Sun Belt
Larry Blakeney,0,22500,51000,269899,320899,2009,Troy,Sun Belt
Larry Blakeney,0,22500,51000,237038,288038,2007,Troy,Sun Belt
Larry Blakeney,0,22500,1000,225750,226750,2006,Troy,Sun Belt
Charlie Strong,0,815000,0,1000000,1000000,2017,South Florida,AAC
Willie Taggart,25000,900000,4000,1700000,1704000,2016,South Florida,AAC
Willie Taggart,0,650000,2500,1150000,1152500,2015,South Florida,AAC
Willie Taggart,0,650000,32000,1150000,1182000,2014,South Florida,AAC
Willie Taggart,0,650000,0,1807745,1807745,2013,South Florida,AAC
Skip Holtz,0,650000,0,2000000,2000000,2012,South Florida,AAC
Skip Holtz,0,350000,0,1700000,1700000,2011,South Florida,AAC
Skip Holtz,0,350000,0,1700000,1700000,2010,South Florida,AAC
Jim Leavitt,0,350000,850000,750000,1600000,2009,South Florida,AAC
Jim Leavitt,0,175000,325000,675000,1000000,2007,South Florida,AAC
Jim Leavitt,0,175000,392500,725000,1117500,2006,South Florida,AAC
Jeff Monken,0,0,0,0,0,2017,Army,Ind.
Jeff Monken,0,256000,0,932521,932521,2016,Army,Ind.
Jeff Monken,0,256000,0,883000,883000,2015,Army,Ind.
Jeff Monken,0,256000,0,834667,834667,2014,Army,Ind.
Rich Ellerson,0,550000,0,401500,401500,2013,Army,Ind.
Rich Ellerson,0,350000,0,600000,600000,2012,Army,Ind.
Rich Ellerson,0,350000,0,610000,610000,2011,Army,Ind.
Rich Ellerson,0,550000,0,400000,400000,2010,Army,Ind.
Rich Ellerson,0,450000,200000,200000,400000,2009,Army,Ind.
Stan Brock,0,0,0,0,0,2007,Army,Ind.
Bobby Ross,0,0,0,0,0,2006,Army,Ind.
Troy Calhoun,0,0,0,0,0,2017,Air Force,Mt. West
Troy Calhoun,85000,0,0,885000,885000,2016,Air Force,Mt. West
Troy Calhoun,123750,255000,26500,892500,919000,2015,Air Force,Mt. West
Troy Calhoun,0,247500,26500,866250,892750,2014,Air Force,Mt. West
Troy Calhoun,0,247500,21100,882000,903100,2013,Air Force,Mt. West
Troy Calhoun,0,247000,0,882000,882000,2012,Air Force,Mt. West
Troy Calhoun,0,247500,22845,866250,889095,2011,Air Force,Mt. West
Troy Calhoun,0,580000,18500,725000,743500,2010,Air Force,Mt. West
Troy Calhoun,0,217500,16500,760000,776500,2009,Air Force,Mt. West
Troy Calhoun,0,125000,21500,550000,571500,2007,Air Force,Mt. West
Fisher DeBerry,0,154000,0,755370,755370,2006,Air Force,Mt. West
Scott Frost,45000,250000,0,2000000,2000000,2017,UCF,AAC
Scott Frost,0,250000,0,1700000,1700000,2016,UCF,AAC
George O'Leary,385000,750000,0,1890000,1890000,2015,UCF,AAC
George O'Leary,0,750000,0,1800000,1800000,2014,UCF,AAC
George O'Leary,0,600000,0,1534728,1534728,2013,UCF,AAC
George O'Leary,0,600000,0,1461646,1461646,2012,UCF,AAC
George O'Leary,0,600000,0,1392043,1392043,2011,UCF,AAC
George O'Leary,0,600000,0,1325754,1325754,2010,UCF,AAC
George O'Leary,0,600000,1002159,310466,1312625,2009,UCF,AAC
George O'Leary,0,500000,823750,261250,1085000,2007,UCF,AAC
George O'Leary,0,555000,785000,250000,1035000,2006,UCF,AAC
Joey Jones,42704,183869,30000,535260,565260,2017,South Alabama,Sun Belt
Joey Jones,5000,211025,35000,525000,560000,2016,South Alabama,Sun Belt
Joey Jones,31438,211025,35500,525000,560500,2015,South Alabama,Sun Belt
Joey Jones,0,171000,36000,435000,471000,2014,South Alabama,Sun Belt
Joey Jones,0,38871,26000,358450,384450,2013,South Alabama,Sun Belt
Joey Jones,0,50625,26000,345125,371125,2012,South Alabama,Sun Belt
DJ Durkin,25000,625000,0,2462000,2462000,2017,Maryland,Big Ten
DJ Durkin,0,625000,0,2412000,2412000,2016,Maryland,Big Ten
Randy Edsall,200000,950000,200,2110648,2110848,2015,Maryland,Big Ten
Randy Edsall,0,950000,200,2033680,2033880,2014,Maryland,Big Ten
Randy Edsall,0,950000,4000,2021440,2025440,2013,Maryland,Big Ten
Randy Edsall,0,950000,4000,1600000,1604000,2012,Maryland,Big Ten
Randy Edsall,0,875000,0,2013440,2013440,2011,Maryland,Big Ten
Ralph Friedgen,0,737232,7000,2036306,2043306,2010,Maryland,Big Ten
Ralph Friedgen,0,701954,1609627,267468,1877095,2009,Maryland,Big Ten
Ralph Friedgen,0,636692,1506070,244136,1750206,2007,Maryland,Big Ten
Ralph Friedgen,0,550000,1439353,252511,1691864,2006,Maryland,Big Ten
David Bailiff,0,0,0,772883,772883,2017,Rice,C-USA
David Bailiff,0,0,0,903556,903556,2016,Rice,C-USA
David Bailiff,0,0,0,805088,805088,2015,Rice,C-USA
David Bailiff,0,0,0,780243,780243,2014,Rice,C-USA
David Bailiff,0,0,0,646386,646386,2013,Rice,C-USA
David Bailiff,0,0,0,608846,608846,2012,Rice,C-USA
David Bailiff,0,0,0,625001,625001,2011,Rice,C-USA
David Bailiff,0,0,0,487340,487340,2010,Rice,C-USA
David Bailiff,0,0,0,476842,476842,2009,Rice,C-USA
David Bailiff,0,0,0,0,0,2007,Rice,C-USA
Todd Graham,0,0,0,0,0,2006,Rice,C-USA
Steve Addazio,0,0,0,2448949,2448949,2017,Boston College,ACC
Steve Addazio,0,0,0,2333628,2333628,2016,Boston College,ACC
Steve Addazio,0,0,0,2585655,2585655,2015,Boston College,ACC
Steve Addazio,0,0,0,0,0,2014,Boston College,ACC
Steve Addazio,0,0,0,0,0,2013,Boston College,ACC
Frank Spaziani,0,0,0,1094976,1094976,2012,Boston College,ACC
Frank Spaziani,0,0,0,1079410,1079410,2011,Boston College,ACC
Frank Spaziani,0,0,0,0,0,2010,Boston College,ACC
Frank Spaziani,0,0,0,0,0,2009,Boston College,ACC
Jeff Jagodzinski,0,0,0,0,0,2007,Boston College,ACC
Tom O'Brien,0,0,0,733626,733626,2006,Boston College,ACC
Rich Rodriguez,25000,2025000,400000,5631563,6031563,2017,Arizona,Pac-12
Rich Rodriguez,50000,2025000,360000,2500000,2860000,2016,Arizona,Pac-12
Rich Rodriguez,650000,2025000,360000,2878844,3238844,2015,Arizona,Pac-12
Rich Rodriguez,0,2125000,400000,2898500,3298500,2014,Arizona,Pac-12
Rich Rodriguez,0,610000,300000,1850000,2150000,2013,Arizona,Pac-12
Rich Rodriguez,0,525000,0,1500000,1500000,2012,Arizona,Pac-12
Mike Stoops,0,700000,265000,1200000,1465000,2011,Arizona,Pac-12
Mike Stoops,0,650000,285838,1100000,1385838,2010,Arizona,Pac-12
Mike Stoops,0,650000,765000,500000,1265000,2009,Arizona,Pac-12
Mike Stoops,0,580000,500000,515288,1015288,2007,Arizona,Pac-12
Mike Stoops,0,395000,450000,415000,865000,2006,Arizona,Pac-12
Kirk Ferentz,600000,2875000,0,4550000,4550000,2017,Iowa,Big Ten
Kirk Ferentz,900000,2875000,0,4500000,4500000,2016,Iowa,Big Ten
Kirk Ferentz,25000,2375000,0,4075000,4075000,2015,Iowa,Big Ten
Kirk Ferentz,0,1750000,0,4075000,4075000,2014,Iowa,Big Ten
Kirk Ferentz,0,1750000,0,3985000,3985000,2013,Iowa,Big Ten
Kirk Ferentz,0,1750000,0,3835000,3835000,2012,Iowa,Big Ten
Kirk Ferentz,0,1750000,0,3785000,3785000,2011,Iowa,Big Ten
Kirk Ferentz,0,1750000,6000,3775000,3781000,2010,Iowa,Big Ten
Kirk Ferentz,0,1000000,4500,3020000,3024500,2009,Iowa,Big Ten
Kirk Ferentz,0,1000000,10000,3020000,3030000,2007,Iowa,Big Ten
Kirk Ferentz,0,1000000,0,2840000,2840000,2006,Iowa,Big Ten
Everett Withers,0,68750,0,675000,675000,2017,Texas State,Sun Belt
Everett Withers,0,66667,0,650000,650000,2016,Texas State,Sun Belt
Dennis Franchione,7500,232500,2000,425000,427000,2015,Texas State,Sun Belt
Dennis Franchione,0,232500,1200,400000,401200,2014,Texas State,Sun Belt
Dennis Franchione,0,132500,7300,366075,373375,2013,Texas State,Sun Belt
Dennis Franchione,0,57500,2300,360500,362800,2012,Texas State,Sun Belt
Pat Narduzzi,0,0,0,1827735,1827735,2017,Pittsburgh,ACC
Pat Narduzzi,0,0,0,0,0,2016,Pittsburgh,ACC
Pat Narduzzi,0,0,0,0,0,2015,Pittsburgh,ACC
Paul Chryst,0,0,0,1578757,1578757,2014,Pittsburgh,ACC
Paul Chryst,0,0,0,0,0,2013,Pittsburgh,ACC
Paul Chryst,0,0,0,0,0,2012,Pittsburgh,ACC
Todd Graham,0,0,0,0,0,2011,Pittsburgh,ACC
Dave Wannstedt,0,0,0,1010873,1010873,2010,Pittsburgh,ACC
Dave Wannstedt,0,0,0,979288,979288,2009,Pittsburgh,ACC
Dave Wannstedt,0,0,0,713138,713138,2007,Pittsburgh,ACC
Dave Wannstedt,0,0,0,0,0,2006,Pittsburgh,ACC
Jim Harbaugh,200000,1325000,0,7004000,7004000,2017,Michigan,Big Ten
Jim Harbaugh,0,1325000,0,9004000,9004000,2016,Michigan,Big Ten
Jim Harbaugh,0,1175000,0,7004000,7004000,2015,Michigan,Big Ten
Brady Hoke,0,575000,2000,2854000,2856000,2014,Michigan,Big Ten
Brady Hoke,0,550000,0,4154000,4154000,2013,Michigan,Big Ten
Brady Hoke,0,525000,0,3046120,3046120,2012,Michigan,Big Ten
Brady Hoke,0,500000,0,3254000,3254000,2011,Michigan,Big Ten
Rich Rodriguez,0,300000,10100,2515180,2525280,2010,Michigan,Big Ten
Rich Rodriguez,0,300000,1662000,859000,2521000,2009,Michigan,Big Ten
Lloyd Carr,0,64648,795000,687884,1482884,2007,Michigan,Big Ten
Lloyd Carr,0,84373,807000,647619,1454619,2006,Michigan,Big Ten
David Shaw,0,0,0,5680441,5680441,2017,Stanford,Pac-12
David Shaw,0,0,0,4067219,4067219,2016,Stanford,Pac-12
David Shaw,0,0,0,2224435,2224435,2015,Stanford,Pac-12
David Shaw,0,0,0,2012666,2012666,2014,Stanford,Pac-12
David Shaw,0,0,0,0,0,2013,Stanford,Pac-12
David Shaw,0,0,0,0,0,2012,Stanford,Pac-12
David Shaw,0,0,0,0,0,2011,Stanford,Pac-12
Jim Harbaugh,0,0,0,0,0,2010,Stanford,Pac-12
Jim Harbaugh,0,0,0,0,0,2009,Stanford,Pac-12
Jim Harbaugh,0,0,0,0,0,2007,Stanford,Pac-12
Walt Harris,0,0,0,0,0,2006,Stanford,Pac-12
Mike Bobo,50000,785000,0,1550000,1550000,2017,Colorado State,Mt. West
Mike Bobo,50000,685000,0,1450000,1450000,2016,Colorado State,Mt. West
Mike Bobo,0,685000,0,1350000,1350000,2015,Colorado State,Mt. West
Jim McElwain,0,150000,0,1500000,1500000,2014,Colorado State,Mt. West
Jim McElwain,0,150000,0,1350000,1350000,2013,Colorado State,Mt. West
Jim McElwain,0,150000,0,1350000,1350000,2012,Colorado State,Mt. West
Steve Fairchild,0,455000,0,700000,700000,2011,Colorado State,Mt. West
Steve Fairchild,0,435000,0,700000,700000,2010,Colorado State,Mt. West
Steve Fairchild,0,455000,350000,350000,700000,2009,Colorado State,Mt. West
Sonny Lubick,0,171625,135000,414500,549500,2007,Colorado State,Mt. West
Sonny Lubick,0,169991,135000,394900,529900,2006,Colorado State,Mt. West
Rick Stockstill,65142,126142,0,801504,801504,2017,Middle Tennessee,C-USA
Rick Stockstill,65142,126142,2500,801504,804004,2016,Middle Tennessee,C-USA
Rick Stockstill,5000,126142,10500,801504,812004,2015,Middle Tennessee,C-USA
Rick Stockstill,0,126142,1625,801504,803129,2014,Middle Tennessee,C-USA
Rick Stockstill,0,157809,2500,701504,704004,2013,Middle Tennessee,C-USA
Rick Stockstill,0,149475,625,601504,602129,2012,Middle Tennessee,C-USA
Rick Stockstill,0,148415,625,588780,589405,2011,Middle Tennessee,C-USA
Rick Stockstill,0,111000,2625,488955,491580,2010,Middle Tennessee,C-USA
Rick Stockstill,0,112180,86500,195155,281655,2009,Middle Tennessee,C-USA
Rick Stockstill,0,75000,75000,207955,282955,2007,Middle Tennessee,C-USA
Rick Stockstill,0,130583,75000,179800,254800,2006,Middle Tennessee,C-USA
Willie Taggart,0,1825000,0,2900000,2900000,2017,Oregon,Pac-12
Mark Helfrich,150000,1635000,12700,3300000,3312700,2016,Oregon,Pac-12
Mark Helfrich,535000,1635000,0,3150000,3150000,2015,Oregon,Pac-12
Mark Helfrich,0,1135000,0,2000000,2000000,2014,Oregon,Pac-12
Mark Helfrich,0,1035000,0,1800000,1800000,2013,Oregon,Pac-12
Chip Kelly,0,900000,0,3500000,3500000,2012,Oregon,Pac-12
Chip Kelly,0,1035000,0,2800000,2800000,2011,Oregon,Pac-12
Chip Kelly,0,885000,0,2400000,2400000,2010,Oregon,Pac-12
Chip Kelly,0,1275000,650000,850000,1500000,2009,Oregon,Pac-12
Mike Bellotti,0,402500,325000,730232,1055232,2007,Oregon,Pac-12
Mike Bellotti,0,368000,155000,1101000,1256000,2006,Oregon,Pac-12
Ed Orgeron,25000,1575000,0,3500000,3500000,2017,LSU,SEC
Les Miles,100000,700000,85567,4300000,4385567,2016,LSU,SEC
Les Miles,100000,700000,88721,4300000,4388721,2015,LSU,SEC
Les Miles,0,700000,69582,4300000,4369582,2014,LSU,SEC
Les Miles,0,700000,159363,4300000,4459363,2013,LSU,SEC
Les Miles,0,700000,105417,3751000,3856417,2012,LSU,SEC
Les Miles,0,700000,105417,3751000,3856417,2011,LSU,SEC
Les Miles,0,400000,154000,3751000,3905000,2010,LSU,SEC
Les Miles,0,650000,3451000,300000,3751000,2009,LSU,SEC
Les Miles,0,525000,966000,850000,1816000,2007,LSU,SEC
Les Miles,0,450000,950000,500000,1450000,2006,LSU,SEC
Blake Anderson,50000,185000,0,750000,750000,2017,Arkansas State,Sun Belt
Blake Anderson,50000,235000,0,700000,700000,2016,Arkansas State,Sun Belt
Blake Anderson,25000,235000,0,700000,700000,2015,Arkansas State,Sun Belt
Blake Anderson,0,235000,0,700000,700000,2014,Arkansas State,Sun Belt
Bryan Harsin,0,245000,0,724597,724597,2013,Arkansas State,Sun Belt
Gus Malzahn,0,160000,3400,856210,859610,2012,Arkansas State,Sun Belt
Hugh Freeze,0,22500,50500,151660,202160,2011,Arkansas State,Sun Belt
Steve Roberts,0,0,83078,140000,223078,2010,Arkansas State,Sun Belt
Steve Roberts,0,0,80162,140000,220162,2009,Arkansas State,Sun Belt
Steve Roberts,0,0,31042,140000,171042,2007,Arkansas State,Sun Belt
Steve Roberts,0,0,49655,140000,189655,2006,Arkansas State,Sun Belt
Scottie Montgomery,75000,850000,0,1050000,1050000,2017,East Carolina,AAC
Scottie Montgomery,0,850000,0,1000000,1000000,2016,East Carolina,AAC
Ruffin McNeill,75000,550000,2500,1414610,1417110,2015,East Carolina,AAC
Ruffin McNeill,0,550000,2500,1250000,1252500,2014,East Carolina,AAC
Ruffin McNeill,0,380000,0,1150000,1150000,2013,East Carolina,AAC
Ruffin McNeill,0,350000,0,950000,950000,2012,East Carolina,AAC
Ruffin McNeill,0,350000,3000,881860,884860,2011,East Carolina,AAC
Ruffin McNeill,0,350000,2000,792241,794241,2010,East Carolina,AAC
Skip Holtz,0,125000,435000,947863,1382863,2009,East Carolina,AAC
Skip Holtz,0,125000,350000,210060,560060,2007,East Carolina,AAC
Skip Holtz,0,75000,275000,150000,425000,2006,East Carolina,AAC
Dino Babers,0,0,0,0,0,2017,Syracuse,ACC
Dino Babers,0,0,0,0,0,2016,Syracuse,ACC
Scott Shafer,0,0,0,1302721,1302721,2015,Syracuse,ACC
Scott Shafer,0,0,0,0,0,2014,Syracuse,ACC
Scott Shafer,0,0,0,0,0,2013,Syracuse,ACC
Doug Marrone,0,0,0,1259276,1259276,2012,Syracuse,ACC
Doug Marrone,0,0,0,1048625,1048625,2011,Syracuse,ACC
Doug Marrone,0,0,0,0,0,2010,Syracuse,ACC
Doug Marrone,0,0,0,0,0,2009,Syracuse,ACC
Greg Robinson,0,0,0,1054172,1054172,2007,Syracuse,ACC
Greg Robinson,0,0,0,638441,638441,2006,Syracuse,ACC
Pat Fitzgerald,0,0,0,3305818,3305818,2017,Northwestern,Big Ten
Pat Fitzgerald,0,0,0,3350638,3350638,2016,Northwestern,Big Ten
Pat Fitzgerald,0,0,0,2490858,2490858,2015,Northwestern,Big Ten
Pat Fitzgerald,0,0,0,2480967,2480967,2014,Northwestern,Big Ten
Pat Fitzgerald,0,0,0,2221153,2221153,2013,Northwestern,Big Ten
Pat Fitzgerald,0,0,0,1280751,1280751,2012,Northwestern,Big Ten
Pat Fitzgerald,0,0,0,1189961,1189961,2011,Northwestern,Big Ten
Pat Fitzgerald,0,0,0,0,0,2010,Northwestern,Big Ten
Pat Fitzgerald,0,0,0,0,0,2009,Northwestern,Big Ten
Pat Fitzgerald,0,0,0,0,0,2007,Northwestern,Big Ten
Pat Fitzgerald,0,0,0,0,0,2006,Northwestern,Big Ten
Jim McElwain,300000,925000,0,4457400,4457400,2017,Florida,SEC
Jim McElwain,100000,450000,0,4268325,4268325,2016,Florida,SEC
Jim McElwain,0,450000,0,3983359,3983359,2015,Florida,SEC
Will Muschamp,0,454000,6500,2724500,2731000,2014,Florida,SEC
Will Muschamp,0,454000,10000,2724500,2734500,2013,Florida,SEC
Will Muschamp,0,450000,0,2474500,2474500,2012,Florida,SEC
Will Muschamp,0,450000,0,3221000,3221000,2011,Florida,SEC
Urban Meyer,0,575000,0,4010000,4010000,2010,Florida,SEC
Urban Meyer,0,0,3750000,250000,4000000,2009,Florida,SEC
Urban Meyer,0,0,3144798,238702,3383500,2007,Florida,SEC
Urban Meyer,0,454000,1032800,491750,1524550,2006,Florida,SEC
Matt Rhule,0,0,0,0,0,2017,Baylor,Big 12
Jim Grobe,0,0,0,0,0,2016,Baylor,Big 12
Art Briles,0,0,2500,4236073,4238573,2015,Baylor,Big 12
Art Briles,0,0,0,3135146,3135146,2014,Baylor,Big 12
Art Briles,0,0,0,2426360,2426360,2013,Baylor,Big 12
Art Briles,0,0,0,2232807,2232807,2012,Baylor,Big 12
Art Briles,0,0,0,1549396,1549396,2011,Baylor,Big 12
Art Briles,0,0,0,878315,878315,2010,Baylor,Big 12
Art Briles,0,0,0,943830,943830,2009,Baylor,Big 12
Guy Morriss,0,0,0,1204818,1204818,2007,Baylor,Big 12
Guy Morriss,0,0,0,1144236,1144236,2006,Baylor,Big 12
Frank Solich,35386,331930,0,522715,522715,2017,Ohio,MAC
Frank Solich,10000,331930,0,572715,572715,2016,Ohio,MAC
Frank Solich,0,329440,1500,562760,564260,2015,Ohio,MAC
Frank Solich,0,327000,1500,553000,554500,2014,Ohio,MAC
Frank Solich,0,299350,11500,502400,513900,2013,Ohio,MAC
Frank Solich,0,297500,11500,500000,511500,2012,Ohio,MAC
Frank Solich,0,288325,11250,465099,476349,2011,Ohio,MAC
Frank Solich,0,288325,2500,458300,460800,2010,Ohio,MAC
Frank Solich,0,287500,71000,385000,456000,2009,Ohio,MAC
Frank Solich,0,190006,11900,257162,269062,2007,Ohio,MAC
Frank Solich,0,162400,12500,249672,262172,2006,Ohio,MAC
Lance Leipold,0,380000,0,405500,405500,2017,Buffalo,MAC
Lance Leipold,0,380000,0,405500,405500,2016,Buffalo,MAC
Lance Leipold,0,380000,0,400000,400000,2015,Buffalo,MAC
Jeff Quinn,0,470000,0,380210,380210,2014,Buffalo,MAC
Jeff Quinn,0,335000,0,325000,325000,2013,Buffalo,MAC
Jeff Quinn,0,330000,0,325000,325000,2012,Buffalo,MAC
Jeff Quinn,0,332500,0,325000,325000,2011,Buffalo,MAC
Jeff Quinn,0,317500,0,338000,338000,2010,Buffalo,MAC
Turner Gill,0,390500,200649,200651,401300,2009,Buffalo,MAC
Turner Gill,0,100592,3000,187700,190700,2007,Buffalo,MAC
Turner Gill,0,87500,3000,180000,183000,2006,Buffalo,MAC
Matt Campbell,0,1000000,0,2100000,2100000,2017,Iowa State,Big 12
Matt Campbell,0,900000,0,2000000,2000000,2016,Iowa State,Big 12
Paul Rhoads,0,950000,5015,2200000,2205015,2015,Iowa State,Big 12
Paul Rhoads,0,1050000,8025,1800000,1808025,2014,Iowa State,Big 12
Paul Rhoads,0,950000,12282,1700000,1712282,2013,Iowa State,Big 12
Paul Rhoads,0,950000,1550,1600000,1601550,2012,Iowa State,Big 12
Paul Rhoads,0,1400000,1500,1150000,1151500,2011,Iowa State,Big 12
Paul Rhoads,0,1550000,1145,1050000,1051145,2010,Iowa State,Big 12
Paul Rhoads,0,850000,700000,250000,950000,2009,Iowa State,Big 12
Gene Chizik,0,825000,775500,250000,1025500,2007,Iowa State,Big 12
Dan McCarney,0,375000,882000,225000,1107000,2006,Iowa State,Big 12
Chuck Martin,51643,548162,0,522300,522300,2017,Miami (OH),MAC
Chuck Martin,6750,498081,0,472300,472300,2016,Miami (OH),MAC
Chuck Martin,20250,482493,0,450000,450000,2015,Miami (OH),MAC
Chuck Martin,0,462243,0,450000,450000,2014,Miami (OH),MAC
Don Treadwell,0,393660,0,400000,400000,2013,Miami (OH),MAC
Don Treadwell,0,421826,0,410000,410000,2012,Miami (OH),MAC
Don Treadwell,0,405612,1000,412000,413000,2011,Miami (OH),MAC
Michael Haywood,0,296496,0,300000,300000,2010,Miami (OH),MAC
Michael Haywood,0,296441,100000,200000,300000,2009,Miami (OH),MAC
Shane Montgomery,0,91484,12900,131325,144225,2007,Miami (OH),MAC
Shane Montgomery,0,27409,12000,127500,139500,2006,Miami (OH),MAC
Rod Carey,17500,205000,0,623000,623000,2017,Northern Illinois,MAC
Rod Carey,52500,205000,2500,623000,625500,2016,Northern Illinois,MAC
Rod Carey,77500,205000,1500,400000,401500,2015,Northern Illinois,MAC
Rod Carey,0,205000,1500,400000,401500,2014,Northern Illinois,MAC
Rod Carey,0,205000,1000,375000,376000,2013,Northern Illinois,MAC
Dave Doeren,0,205000,3000,420000,423000,2012,Northern Illinois,MAC
Dave Doeren,0,205000,0,371000,371000,2011,Northern Illinois,MAC
Jerry Kill,0,205000,1000,346812,347812,2010,Northern Illinois,MAC
Jerry Kill,0,205000,4773,340000,344773,2009,Northern Illinois,MAC
Joe Novak,0,0,0,305136,305136,2007,Northern Illinois,MAC
Joe Novak,0,0,0,212496,212496,2006,Northern Illinois,MAC
Larry Fedora,50000,900000,0,2290000,2290000,2017,North Carolina,ACC
Larry Fedora,58500,348444,0,1986265,1986265,2016,North Carolina,ACC
Larry Fedora,29250,346250,0,1931000,1931000,2015,North Carolina,ACC
Larry Fedora,0,345835,0,1830000,1830000,2014,North Carolina,ACC
Larry Fedora,0,345835,0,1730000,1730000,2013,North Carolina,ACC
Larry Fedora,0,29167,0,2448605,2448605,2012,North Carolina,ACC
Everett Withers,0,100000,0,500000,500000,2011,North Carolina,ACC
Butch Davis,0,105000,0,1752000,1752000,2010,North Carolina,ACC
Butch Davis,0,105000,0,1702000,1702000,2009,North Carolina,ACC
Butch Davis,0,95333,499000,1411000,1910000,2007,North Carolina,ACC
John Bunting,0,43334,0,311200,311200,2006,North Carolina,ACC
Paul Johnson,425000,1050000,0,2970891,2970891,2017,Georgia Tech,ACC
Paul Johnson,235000,1050000,2000,2884361,2886361,2016,Georgia Tech,ACC
Paul Johnson,450000,1050000,2000,2800000,2802000,2015,Georgia Tech,ACC
Paul Johnson,0,1275000,2500,2588000,2590500,2014,Georgia Tech,ACC
Paul Johnson,0,1025000,2500,2513000,2515500,2013,Georgia Tech,ACC
Paul Johnson,0,1025000,5000,2440700,2445700,2012,Georgia Tech,ACC
Paul Johnson,0,1125000,0,2369000,2369000,2011,Georgia Tech,ACC
Paul Johnson,0,1125000,0,2300000,2300000,2010,Georgia Tech,ACC
Paul Johnson,0,1025000,1975000,325000,2300000,2009,Georgia Tech,ACC
Chan Gailey,0,260000,579886,459461,1039347,2007,Georgia Tech,ACC
Chan Gailey,0,260000,571609,437582,1009191,2006,Georgia Tech,ACC
Ken Niumatalolo,0,0,0,2000000,2000000,2017,Navy,AAC
Ken Niumatalolo,0,0,0,2000000,2000000,2016,Navy,AAC
Ken Niumatalolo,0,0,0,1637803,1637803,2015,Navy,AAC
Ken Niumatalolo,0,0,0,1574810,1574810,2014,Navy,AAC
Ken Niumatalolo,0,0,0,1514240,1514240,2013,Navy,AAC
Ken Niumatalolo,0,0,0,1605370,1605370,2012,Navy,AAC
Ken Niumatalolo,0,0,0,1538190,1538190,2011,Navy,AAC
Ken Niumatalolo,0,0,0,1852868,1852868,2010,Navy,AAC
Ken Niumatalolo,0,0,0,468464,468464,2009,Navy,AAC
Paul Johnson,0,0,0,1049311,1049311,2007,Navy,AAC
Paul Johnson,0,0,0,1003309,1003309,2006,Navy,AAC
Justin Fuente,125000,435000,0,3250000,3250000,2017,Virginia Tech,ACC
Justin Fuente,0,400000,0,3200000,3200000,2016,Virginia Tech,ACC
Frank Beamer,42500,382500,240000,2535925,2775925,2015,Virginia Tech,ACC
Frank Beamer,0,382500,240000,2420913,2660913,2014,Virginia Tech,ACC
Frank Beamer,0,382500,50000,2491616,2541616,2013,Virginia Tech,ACC
Frank Beamer,0,407500,85000,2343000,2428000,2012,Virginia Tech,ACC
Frank Beamer,0,407500,85000,2243000,2328000,2011,Virginia Tech,ACC
Frank Beamer,0,407500,85000,2043000,2128000,2010,Virginia Tech,ACC
Frank Beamer,0,407500,1865672,272328,2138000,2009,Virginia Tech,ACC
Frank Beamer,0,407500,1735672,272328,2008000,2007,Virginia Tech,ACC
Frank Beamer,0,407500,115000,1893000,2008000,2006,Virginia Tech,ACC
Skip Holtz,50000,395000,4000,700000,704000,2017,Louisiana Tech,C-USA
Skip Holtz,25000,295000,15000,500000,515000,2016,Louisiana Tech,C-USA
Skip Holtz,25000,295000,17000,500000,517000,2015,Louisiana Tech,C-USA
Skip Holtz,0,295000,10000,500000,510000,2014,Louisiana Tech,C-USA
Skip Holtz,0,295000,10000,500000,510000,2013,Louisiana Tech,C-USA
Sonny Dykes,0,310000,10200,750000,760200,2012,Louisiana Tech,C-USA
Sonny Dykes,0,310000,10500,450000,460500,2011,Louisiana Tech,C-USA
Sonny Dykes,0,310000,0,450000,450000,2010,Louisiana Tech,C-USA
Derek Dooley,0,110000,205000,200000,405000,2009,Louisiana Tech,C-USA
Derek Dooley,0,100000,150000,200000,350000,2007,Louisiana Tech,C-USA
Jack Bicknell III,0,0,58500,150000,208500,2006,Louisiana Tech,C-USA
Lincoln Riley,0,700000,0,2116666,2116666,2017,Oklahoma,Big 12
Bob Stoops,333000,834000,0,5550000,5550000,2016,Oklahoma,Big 12
Bob Stoops,75000,834000,0,5400000,5400000,2015,Oklahoma,Big 12
Bob Stoops,0,819500,0,5058333,5058333,2014,Oklahoma,Big 12
Bob Stoops,0,819500,31500,4741667,4773167,2013,Oklahoma,Big 12
Bob Stoops,0,819500,0,4550000,4550000,2012,Oklahoma,Big 12
Bob Stoops,0,819500,0,4075000,4075000,2011,Oklahoma,Big 12
Bob Stoops,0,819500,100000,4275000,4375000,2010,Oklahoma,Big 12
Bob Stoops,0,819500,2953000,1350000,4303000,2009,Oklahoma,Big 12
Bob Stoops,0,745000,2650000,970000,3620000,2007,Oklahoma,Big 12
Bob Stoops,0,745000,2500000,950000,3450000,2006,Oklahoma,Big 12
Gary Patterson,0,0,0,5104077,5104077,2017,TCU,Big 12
Gary Patterson,0,0,0,4014723,4014723,2016,TCU,Big 12
Gary Patterson,0,0,0,3940026,3940026,2015,TCU,Big 12
Gary Patterson,0,0,0,4008150,4008150,2014,TCU,Big 12
Gary Patterson,0,0,0,3120760,3120760,2013,TCU,Big 12
Gary Patterson,0,0,0,3467926,3467926,2012,TCU,Big 12
Gary Patterson,0,0,0,2018362,2018362,2011,TCU,Big 12
Gary Patterson,0,0,0,1642089,1642089,2010,TCU,Big 12
Gary Patterson,0,0,0,1800000,1800000,2009,TCU,Big 12
Gary Patterson,0,0,0,1219212,1219212,2007,TCU,Big 12
Gary Patterson,0,0,0,952162,952162,2006,TCU,Big 12
Bobby Petrino,989584,1468750,0,3930434,3930434,2017,Louisville,ACC
Bobby Petrino,794667,1464583,30000,3880434,3910434,2016,Louisville,ACC
Bobby Petrino,782667,1341667,3500,3000000,3003500,2015,Louisville,ACC
Bobby Petrino,0,1266667,0,3000000,3000000,2014,Louisville,ACC
Charlie Strong,0,808333,38500,3700000,3738500,2013,Louisville,ACC
Charlie Strong,0,691666,5000,2300000,2305000,2012,Louisville,ACC
Charlie Strong,0,500000,5000,2300000,2305000,2011,Louisville,ACC
Charlie Strong,0,633333,0,1600000,1600000,2010,Louisville,ACC
Steve Kragthorpe,0,525000,666000,550000,1216000,2009,Louisville,ACC
Steve Kragthorpe,0,566667,555000,865000,1420000,2007,Louisville,ACC
Bobby Petrino,0,766667,941000,810000,1751000,2006,Louisville,ACC
Bill Clark,0,685000,0,630000,630000,2017,UAB,C-USA
Bill Clark,0,430000,0,500000,500000,2014,UAB,C-USA
Garrick McGee,0,330000,0,550000,550000,2013,UAB,C-USA
Garrick McGee,0,465000,0,550000,550000,2012,UAB,C-USA
Neil Callaway,0,305000,3800,443000,446800,2011,UAB,C-USA
Neil Callaway,0,305000,3800,378000,381800,2010,UAB,C-USA
Neil Callaway,0,275000,68800,335000,403800,2009,UAB,C-USA
Neil Callaway,0,275000,60000,306508,366508,2007,UAB,C-USA
Watson Brown,0,0,11500,360000,371500,2006,UAB,C-USA
Bret Bielema,125000,1000000,45000,4200000,4245000,2017,Arkansas,SEC
Bret Bielema,100000,1000000,45000,4100000,4145000,2016,Arkansas,SEC
Bret Bielema,100000,1000000,6500,3954166,3960666,2015,Arkansas,SEC
Bret Bielema,0,700000,14000,3200000,3214000,2014,Arkansas,SEC
Bret Bielema,0,700000,0,5158863,5158863,2013,Arkansas,SEC
John L. Smith,0,225000,0,850000,850000,2012,Arkansas,SEC
Bobby Petrino,0,650000,3000,3635000,3638000,2011,Arkansas,SEC
Bobby Petrino,0,475000,13000,2700000,2713000,2010,Arkansas,SEC
Bobby Petrino,0,550000,958000,1900000,2858000,2009,Arkansas,SEC
Houston Nutt,0,125000,861500,389644,1251144,2007,Arkansas,SEC
Houston Nutt,0,125000,720000,329644,1049644,2006,Arkansas,SEC
Bob Davie,20000,490000,1250,822690,823940,2017,New Mexico,Mt. West
Bob Davie,20000,490000,1250,822690,823940,2016,New Mexico,Mt. West
Bob Davie,0,490000,1250,772690,773940,2015,New Mexico,Mt. West
Bob Davie,0,480000,11000,772690,783690,2014,New Mexico,Mt. West
Bob Davie,0,330000,0,763600,763600,2013,New Mexico,Mt. West
Bob Davie,0,350000,0,760000,760000,2012,New Mexico,Mt. West
Mike Locksley,0,315000,10500,750000,760500,2011,New Mexico,Mt. West
Mike Locksley,0,265000,10500,750000,760500,2010,New Mexico,Mt. West
Mike Locksley,0,265000,450650,300000,750650,2009,New Mexico,Mt. West
Rocky Long,0,0,75000,364513,439513,2007,New Mexico,Mt. West
Rocky Long,0,0,75000,356175,431175,2006,New Mexico,Mt. West
Mike Leach,75000,725000,0,3075000,3075000,2017,Washington State,Pac-12
Mike Leach,100000,725000,0,2950000,2950000,2016,Washington State,Pac-12
Mike Leach,0,625000,0,2750000,2750000,2015,Washington State,Pac-12
Mike Leach,0,625000,0,2750000,2750000,2014,Washington State,Pac-12
Mike Leach,0,625000,0,2250000,2250000,2013,Washington State,Pac-12
Mike Leach,0,640000,0,2250000,2250000,2012,Washington State,Pac-12
Paul Wulff,0,220000,50,600000,600050,2011,Washington State,Pac-12
Paul Wulff,0,220000,650,600000,600650,2010,Washington State,Pac-12
Paul Wulff,0,320000,350100,250000,600100,2009,Washington State,Pac-12
Bill Doba,0,255000,361500,294960,656460,2007,Washington State,Pac-12
Bill Doba,0,255000,369975,229067,599042,2006,Washington State,Pac-12
Geoff Collins,0,0,0,0,0,2017,Temple,AAC
Matt Rhule,0,0,0,1041739,1041739,2016,Temple,AAC
Matt Rhule,0,0,0,648633,648633,2015,Temple,AAC
Matt Rhule,0,0,0,0,0,2014,Temple,AAC
Matt Rhule,0,0,0,0,0,2013,Temple,AAC
Steve Addazio,0,0,0,0,0,2012,Temple,AAC
Steve Addazio,0,0,0,0,0,2011,Temple,AAC
Al Golden,0,0,0,513867,513867,2010,Temple,AAC
Al Golden,0,0,0,505000,505000,2009,Temple,AAC
Al Golden,0,0,0,0,0,2007,Temple,AAC
Al Golden,0,0,0,0,0,2006,Temple,AAC
Mike Gundy,62500,900000,0,4200000,4200000,2017,Oklahoma State,Big 12
Mike Gundy,100000,550000,0,3775000,3775000,2016,Oklahoma State,Big 12
Mike Gundy,62500,550000,0,3650000,3650000,2015,Oklahoma State,Big 12
Mike Gundy,0,550000,0,3500000,3500000,2014,Oklahoma State,Big 12
Mike Gundy,0,550000,0,3450000,3450000,2013,Oklahoma State,Big 12
Mike Gundy,0,550000,0,3275000,3275000,2012,Oklahoma State,Big 12
Mike Gundy,0,500000,0,2100000,2100000,2011,Oklahoma State,Big 12
Mike Gundy,0,500000,0,1925000,1925000,2010,Oklahoma State,Big 12
Mike Gundy,0,500000,1425000,375000,1800000,2009,Oklahoma State,Big 12
Mike Gundy,0,684000,675000,275000,950000,2007,Oklahoma State,Big 12
Mike Gundy,0,684000,550000,250000,800000,2006,Oklahoma State,Big 12
Derek Mason,0,0,0,2721834,2721834,2017,Vanderbilt,SEC
Derek Mason,0,0,0,2556877,2556877,2016,Vanderbilt,SEC
Derek Mason,0,0,0,0,0,2015,Vanderbilt,SEC
Derek Mason,0,0,0,0,0,2014,Vanderbilt,SEC
James Franklin,0,0,0,1842771,1842771,2013,Vanderbilt,SEC
James Franklin,0,0,0,0,0,2012,Vanderbilt,SEC
James Franklin,0,0,0,0,0,2011,Vanderbilt,SEC
Robbie Caldwell,0,0,0,0,0,2010,Vanderbilt,SEC
Bobby Johnson,0,0,0,0,0,2009,Vanderbilt,SEC
Bobby Johnson,0,0,0,0,0,2007,Vanderbilt,SEC
Bobby Johnson,0,0,0,0,0,2006,Vanderbilt,SEC
Sean Kugler,24611,493776,0,515332,515332,2017,UTEP,C-USA
Sean Kugler,24128,493776,0,515332,515332,2016,UTEP,C-USA
Sean Kugler,75044,486052,4500,509541,514041,2015,UTEP,C-USA
Sean Kugler,0,478481,4500,503864,508364,2014,UTEP,C-USA
Sean Kugler,0,449999,0,500000,500000,2013,UTEP,C-USA
Mike Price,0,320853,9000,359206,368206,2012,UTEP,C-USA
Mike Price,0,320853,10000,383706,393706,2011,UTEP,C-USA
Mike Price,0,320853,11500,383346,394846,2010,UTEP,C-USA
Mike Price,0,323167,60000,428666,488666,2009,UTEP,C-USA
Mike Price,0,349998,50000,410000,460000,2007,UTEP,C-USA
Mike Price,0,263334,59500,483500,543000,2006,UTEP,C-USA
Gary Andersen,50000,525000,0,2650000,2650000,2017,Oregon State,Pac-12
Gary Andersen,0,525000,0,2550000,2550000,2016,Oregon State,Pac-12
Gary Andersen,0,525000,0,2450000,2450000,2015,Oregon State,Pac-12
Mike Riley,0,369000,0,1510008,1510008,2014,Oregon State,Pac-12
Mike Riley,0,360000,0,1417843,1417843,2013,Oregon State,Pac-12
Mike Riley,0,360000,0,1317847,1317847,2012,Oregon State,Pac-12
Mike Riley,0,360000,0,1313471,1313471,2011,Oregon State,Pac-12
Mike Riley,0,360000,0,1110000,1110000,2010,Oregon State,Pac-12
Mike Riley,0,395000,425000,525000,950000,2009,Oregon State,Pac-12
Mike Riley,0,360000,425000,460000,885000,2007,Oregon State,Pac-12
Mike Riley,0,295000,425000,410000,835000,2006,Oregon State,Pac-12
Justin Wilcox,0,900000,0,1600000,1600000,2017,California,Pac-12
Sonny Dykes,50000,800000,8000,2900000,2908000,2016,California,Pac-12
Sonny Dykes,0,304000,8000,2000000,2008000,2015,California,Pac-12
Sonny Dykes,0,304000,8000,1800000,1808000,2014,California,Pac-12
Sonny Dykes,0,304000,0,2394000,2394000,2013,California,Pac-12
Jeff Tedford,0,255000,0,2600000,2600000,2012,California,Pac-12
Jeff Tedford,0,255000,0,2300000,2300000,2011,California,Pac-12
Jeff Tedford,0,265000,5000,2300000,2305000,2010,California,Pac-12
Jeff Tedford,0,265000,1582500,1225000,2807500,2009,California,Pac-12
Jeff Tedford,0,400000,1580800,225000,1805800,2007,California,Pac-12
Jeff Tedford,0,350000,1337800,167500,1505300,2006,California,Pac-12
Terry Bowden,5000,225000,1500,411000,412500,2017,Akron,MAC
Terry Bowden,30000,225000,1500,411000,412500,2016,Akron,MAC
Terry Bowden,10000,255000,1500,406000,407500,2015,Akron,MAC
Terry Bowden,0,255000,0,406000,406000,2014,Akron,MAC
Terry Bowden,0,205000,0,400000,400000,2013,Akron,MAC
Terry Bowden,0,90000,0,375000,375000,2012,Akron,MAC
Rob Ianello,0,155000,0,375000,375000,2011,Akron,MAC
Rob Ianello,0,155000,0,375000,375000,2010,Akron,MAC
J.D. Brookhart,0,248148,50000,196292,246292,2009,Akron,MAC
J.D. Brookhart,0,229960,55000,188888,243888,2007,Akron,MAC
J.D. Brookhart,0,17500,25000,182500,207500,2006,Akron,MAC
Paul Haynes,1000,173000,0,414030,414030,2017,Kent State,MAC
Paul Haynes,12000,173000,1000,405912,406912,2016,Kent State,MAC
Paul Haynes,1000,173000,2200,390150,392350,2015,Kent State,MAC
Paul Haynes,0,336000,1200,382500,383700,2014,Kent State,MAC
Paul Haynes,0,261000,0,382500,382500,2013,Kent State,MAC
Darrell Hazell,0,76000,0,300000,300000,2012,Kent State,MAC
Darrell Hazell,0,96000,0,300000,300000,2011,Kent State,MAC
Doug Martin,0,91500,0,190000,190000,2010,Kent State,MAC
Doug Martin,0,91500,0,190000,190000,2009,Kent State,MAC
Doug Martin,0,84000,0,170000,170000,2007,Kent State,MAC
Doug Martin,0,42000,0,150200,150200,2006,Kent State,MAC
Mike Norvell,125000,570000,0,1860000,1860000,2017,Memphis,AAC
Mike Norvell,0,570000,0,1800000,1800000,2016,Memphis,AAC
Justin Fuente,235000,725000,0,1400000,1400000,2015,Memphis,AAC
Justin Fuente,0,725000,0,1006779,1006779,2014,Memphis,AAC
Justin Fuente,0,625000,0,956779,956779,2013,Memphis,AAC
Justin Fuente,0,625000,0,903285,903285,2012,Memphis,AAC
Larry Porter,0,190000,0,754890,754890,2011,Memphis,AAC
Larry Porter,0,190000,0,750000,750000,2010,Memphis,AAC
Tommy West,0,400000,770000,155000,925000,2009,Memphis,AAC
Tommy West,0,430000,771000,159650,930650,2007,Memphis,AAC
Tommy West,0,430000,770000,155000,925000,2006,Memphis,AAC
Kirby Smart,75000,1800000,0,3753600,3753600,2017,Georgia,SEC
Kirby Smart,0,1800000,0,3753600,3753600,2016,Georgia,SEC
Mark Richt,75000,1800000,124000,4000000,4124000,2015,Georgia,SEC
Mark Richt,0,1000000,114000,3200000,3314000,2014,Georgia,SEC
Mark Richt,0,1000000,114000,3200000,3314000,2013,Georgia,SEC
Mark Richt,0,1000000,114000,2811340,2925340,2012,Georgia,SEC
Mark Richt,0,525000,128400,2811400,2939800,2011,Georgia,SEC
Mark Richt,0,600000,126400,2811340,2937740,2010,Georgia,SEC
Mark Richt,0,475000,2287236,809340,3096576,2009,Georgia,SEC
Mark Richt,0,400000,1446600,578100,2024700,2007,Georgia,SEC
Mark Richt,0,400000,1443000,270000,1713000,2006,Georgia,SEC
Chad Morris,0,0,0,2095793,2095793,2017,Southern Methodist,AAC
Chad Morris,0,0,0,0,0,2016,Southern Methodist,AAC
Chad Morris,0,0,0,0,0,2015,Southern Methodist,AAC
June Jones,0,0,0,2019718,2019718,2014,Southern Methodist,AAC
June Jones,0,0,0,1911511,1911511,2013,Southern Methodist,AAC
June Jones,0,0,0,1825089,1825089,2012,Southern Methodist,AAC
June Jones,0,0,0,1727082,1727082,2011,Southern Methodist,AAC
June Jones,0,0,0,2142056,2142056,2010,Southern Methodist,AAC
June Jones,0,0,0,1206368,1206368,2009,Southern Methodist,AAC
Phil Bennett,0,0,0,517857,517857,2007,Southern Methodist,AAC
Phil Bennett,0,0,0,495602,495602,2006,Southern Methodist,AAC
Chris Ash,50000,960000,0,2100000,2100000,2017,Rutgers,Big Ten
Chris Ash,0,960000,0,2000000,2000000,2016,Rutgers,Big Ten
Kyle Flood,85000,425000,10000,1250000,1260000,2015,Rutgers,Big Ten
Kyle Flood,0,350000,12000,975000,987000,2014,Rutgers,Big Ten
Kyle Flood,0,350000,10000,850000,860000,2013,Rutgers,Big Ten
Kyle Flood,0,350000,10000,750000,760000,2012,Rutgers,Big Ten
Greg Schiano,0,530000,101969,2195000,2296969,2011,Rutgers,Big Ten
Greg Schiano,0,630000,105932,1895000,2000932,2010,Rutgers,Big Ten
Greg Schiano,0,530000,355932,1715000,2070932,2009,Rutgers,Big Ten
Greg Schiano,0,530000,133500,1600000,1733500,2007,Rutgers,Big Ten
Greg Schiano,0,480000,36000,875000,911000,2006,Rutgers,Big Ten
Kalani Sitake,0,0,0,0,0,2017,Brigham Young,Ind.
Kalani Sitake,0,0,0,0,0,2016,Brigham Young,Ind.
Bronco Mendenhall,0,0,0,0,0,2015,Brigham Young,Ind.
Bronco Mendenhall,0,0,0,0,0,2014,Brigham Young,Ind.
Bronco Mendenhall,0,0,0,0,0,2013,Brigham Young,Ind.
Bronco Mendenhall,0,0,0,0,0,2012,Brigham Young,Ind.
Bronco Mendenhall,0,0,0,0,0,2011,Brigham Young,Ind.
Bronco Mendenhall,0,0,0,0,0,2010,Brigham Young,Ind.
Bronco Mendenhall,0,0,0,0,0,2009,Brigham Young,Ind.
Bronco Mendenhall,0,0,0,0,0,2007,Brigham Young,Ind.
Bronco Mendenhall,0,0,0,0,0,2006,Brigham Young,Ind.
Mike Neu,0,370000,5000,431375,436375,2017,Ball State,MAC
Mike Neu,0,370000,3500,425000,428500,2016,Ball State,MAC
Pete Lembo,2500,460000,3500,514250,517750,2015,Ball State,MAC
Pete Lembo,0,450000,3500,500000,503500,2014,Ball State,MAC
Pete Lembo,0,265000,3000,396000,399000,2013,Ball State,MAC
Pete Lembo,0,265000,2800,350000,352800,2012,Ball State,MAC
Pete Lembo,0,265000,300,350000,350300,2011,Ball State,MAC
Stan Parrish,0,250000,0,350000,350000,2010,Ball State,MAC
Stan Parrish,0,235000,0,350000,350000,2009,Ball State,MAC
Brady Hoke,0,62500,5345,164289,169634,2007,Ball State,MAC
Brady Hoke,0,0,26250,132970,159220,2006,Ball State,MAC
Brian Kelly,0,0,0,1645867,1645867,2017,Notre Dame,Ind.
Brian Kelly,0,0,0,1624730,1624730,2016,Notre Dame,Ind.
Brian Kelly,0,0,0,1187272,1187272,2015,Notre Dame,Ind.
Brian Kelly,0,0,0,1457284,1457284,2014,Notre Dame,Ind.
Brian Kelly,0,0,0,1088179,1088179,2013,Notre Dame,Ind.
Brian Kelly,0,0,0,2424301,2424301,2012,Notre Dame,Ind.
Brian Kelly,0,0,0,0,0,2011,Notre Dame,Ind.
Brian Kelly,0,0,0,0,0,2010,Notre Dame,Ind.
Charlie Weis,0,0,0,640851,640851,2009,Notre Dame,Ind.
Charlie Weis,0,0,0,673779,673779,2007,Notre Dame,Ind.
Charlie Weis,0,0,0,0,0,2006,Notre Dame,Ind.
David Cutcliffe,0,0,0,2613638,2613638,2017,Duke,ACC
David Cutcliffe,0,0,0,2320773,2320773,2016,Duke,ACC
David Cutcliffe,0,0,0,2049055,2049055,2015,Duke,ACC
David Cutcliffe,0,0,0,1840341,1840341,2014,Duke,ACC
David Cutcliffe,0,0,0,1792285,1792285,2013,Duke,ACC
David Cutcliffe,0,0,0,1788523,1788523,2012,Duke,ACC
David Cutcliffe,0,0,0,1762895,1762895,2011,Duke,ACC
David Cutcliffe,0,0,0,1581903,1581903,2010,Duke,ACC
David Cutcliffe,0,0,0,0,0,2009,Duke,ACC
Ted Roof,0,0,0,544286,544286,2007,Duke,ACC
Ted Roof,0,0,0,370200,370200,2006,Duke,ACC
Mike MacIntyre,772500,2150000,0,2803500,2803500,2017,Colorado,Pac-12
Mike MacIntyre,300000,1500000,400,2011050,2011450,2016,Colorado,Pac-12
Mike MacIntyre,292000,1500000,575,2009778,2010353,2015,Colorado,Pac-12
Mike MacIntyre,0,1500000,1650,2008500,2010150,2014,Colorado,Pac-12
Mike MacIntyre,0,1500000,0,2403500,2403500,2013,Colorado,Pac-12
Jon Embree,0,1400000,0,725000,725000,2012,Colorado,Pac-12
Jon Embree,0,1400000,0,725000,725000,2011,Colorado,Pac-12
Dan Hawkins,0,985444,8000,1383903,1391903,2010,Colorado,Pac-12
Dan Hawkins,0,900000,825850,174720,1000570,2009,Colorado,Pac-12
Dan Hawkins,0,550000,769500,166400,935900,2007,Colorado,Pac-12
Dan Hawkins,0,550000,743500,355000,1098500,2006,Colorado,Pac-12
Dan Mullen,150000,1150000,0,4500000,4500000,2017,Mississippi State,SEC
Dan Mullen,200000,900000,0,4200000,4200000,2016,Mississippi State,SEC
Dan Mullen,390000,900000,0,4000000,4000000,2015,Mississippi State,SEC
Dan Mullen,0,710000,0,3000000,3000000,2014,Mississippi State,SEC
Dan Mullen,0,650000,0,2700000,2700000,2013,Mississippi State,SEC
Dan Mullen,0,650000,0,2600000,2600000,2012,Mississippi State,SEC
Dan Mullen,0,650000,0,2500000,2500000,2011,Mississippi State,SEC
Dan Mullen,0,0,8295,1200000,1208295,2010,Mississippi State,SEC
Dan Mullen,0,100000,950000,250000,1200000,2009,Mississippi State,SEC
Sylvester Croom,0,0,770000,205000,975000,2007,Mississippi State,SEC
Sylvester Croom,0,15833,750000,190000,940000,2006,Mississippi State,SEC
Bobby Wilder,10000,504506,0,650000,650000,2017,Old Dominion,C-USA
Bobby Wilder,0,504506,15000,554590,569590,2016,Old Dominion,C-USA
Bobby Wilder,0,504125,15000,550000,565000,2015,Old Dominion,C-USA
Bobby Wilder,0,503333,11010,475000,486010,2014,Old Dominion,C-USA
Bobby Wilder,0,0,0,450000,450000,2013,Old Dominion,C-USA
Doc Holliday,25000,145000,0,762570,762570,2017,Marshall,C-USA
Doc Holliday,55000,145000,2750,762570,765320,2016,Marshall,C-USA
Doc Holliday,95000,145000,2750,755500,758250,2015,Marshall,C-USA
Doc Holliday,0,115000,2750,607070,609820,2014,Marshall,C-USA
Doc Holliday,0,80000,14250,607070,621320,2013,Marshall,C-USA
Doc Holliday,0,80000,12750,600000,612750,2012,Marshall,C-USA
Doc Holliday,0,80000,12750,607070,619820,2011,Marshall,C-USA
Doc Holliday,0,80000,17750,600000,617750,2010,Marshall,C-USA
Mark Snyder,0,80000,180739,187056,367795,2009,Marshall,C-USA
Mark Snyder,0,80000,175936,294977,470913,2007,Marshall,C-USA
Mark Snyder,0,130000,246403,144200,390603,2006,Marshall,C-USA
Mike Jinks,25000,245000,0,428655,428655,2017,Bowling Green,MAC
Mike Jinks,0,245000,0,410000,410000,2016,Bowling Green,MAC
Dino Babers,107500,245000,0,413000,413000,2015,Bowling Green,MAC
Dino Babers,0,130000,0,405000,405000,2014,Bowling Green,MAC
Dave Clawson,0,109000,1000,400000,401000,2013,Bowling Green,MAC
Dave Clawson,0,116000,1200,363000,364200,2012,Bowling Green,MAC
Dave Clawson,0,111000,1200,363000,364200,2011,Bowling Green,MAC
Dave Clawson,0,98000,1000,205000,206000,2010,Bowling Green,MAC
Dave Clawson,0,100000,86000,215000,301000,2009,Bowling Green,MAC
Gregg Brandon,0,54000,20000,163909,183909,2007,Bowling Green,MAC
Gregg Brandon,0,50000,20000,130000,150000,2006,Bowling Green,MAC
Jim Mora,95000,1065000,0,3550000,3550000,2017,UCLA,Pac-12
Jim Mora,120000,1065000,0,3450000,3450000,2016,UCLA,Pac-12
Jim Mora,145000,930000,0,3350000,3350000,2015,UCLA,Pac-12
Jim Mora,0,930000,0,3250000,3250000,2014,UCLA,Pac-12
Jim Mora,0,750000,0,2300000,2300000,2013,UCLA,Pac-12
Jim Mora,0,750000,0,1935000,1935000,2012,UCLA,Pac-12
Rick Neuheisel,0,500000,35000,1250000,1285000,2011,UCLA,Pac-12
Rick Neuheisel,0,500000,26000,1250000,1276000,2010,UCLA,Pac-12
Rick Neuheisel,0,500000,1026000,250000,1276000,2009,UCLA,Pac-12
Karl Dorrell,0,505000,700000,150000,850000,2007,UCLA,Pac-12
Karl Dorrell,0,505000,700000,181000,881000,2006,UCLA,Pac-12
Gus Malzahn,275000,1400000,1960,4725000,4726960,2017,Auburn,SEC
Gus Malzahn,125000,1400000,4500,4725000,4729500,2016,Auburn,SEC
Gus Malzahn,125000,1400000,4500,4100000,4104500,2015,Auburn,SEC
Gus Malzahn,0,1400000,4500,3850000,3854500,2014,Auburn,SEC
Gus Malzahn,0,1250000,0,2440000,2440000,2013,Auburn,SEC
Gene Chizik,0,1200000,77500,3500000,3577500,2012,Auburn,SEC
Gene Chizik,0,1200000,0,3500000,3500000,2011,Auburn,SEC
Gene Chizik,0,1500000,3500,2100000,2103500,2010,Auburn,SEC
Gene Chizik,0,1300000,1550000,500000,2050000,2009,Auburn,SEC
Tommy Tuberville,0,717500,2190000,435000,2625000,2007,Auburn,SEC
Tommy Tuberville,0,716154,1996000,235000,2231000,2006,Auburn,SEC
Chris Creighton,35000,395000,0,442420,442420,2017,Eastern Michigan,MAC
Chris Creighton,0,310000,0,434840,434840,2016,Eastern Michigan,MAC
Chris Creighton,0,310000,0,425000,425000,2015,Eastern Michigan,MAC
Chris Creighton,0,310000,0,425000,425000,2014,Eastern Michigan,MAC
Ron English,0,90000,0,374937,374937,2013,Eastern Michigan,MAC
Ron English,0,90000,0,360517,360517,2012,Eastern Michigan,MAC
Ron English,0,90000,0,343350,343350,2011,Eastern Michigan,MAC
Ron English,0,90000,1000,315000,316000,2010,Eastern Michigan,MAC
Ron English,0,90000,25000,275000,300000,2009,Eastern Michigan,MAC
Jeff Genyk,0,86000,13000,183000,196000,2007,Eastern Michigan,MAC
Jeff Genyk,0,10000,13000,141442,154442,2006,Eastern Michigan,MAC
Kevin Sumlin,100000,1050000,0,5000000,5000000,2017,Texas A&M,SEC
Kevin Sumlin,50000,1350000,0,5000000,5000000,2016,Texas A&M,SEC
Kevin Sumlin,50000,1350000,0,5000000,5000000,2015,Texas A&M,SEC
Kevin Sumlin,0,750000,6000,5000000,5006000,2014,Texas A&M,SEC
Kevin Sumlin,0,750000,300,3100000,3100300,2013,Texas A&M,SEC
Kevin Sumlin,0,625000,300,2436000,2436300,2012,Texas A&M,SEC
Mike Sherman,0,350000,1000,2200000,2201000,2011,Texas A&M,SEC
Mike Sherman,0,350000,1000,1800000,1801000,2010,Texas A&M,SEC
Mike Sherman,0,350000,1301650,500001,1801651,2009,Texas A&M,SEC
Dennis Franchione,0,350000,1547216,527000,2074216,2007,Texas A&M,SEC
Dennis Franchione,0,350000,1507700,512000,2019700,2006,Texas A&M,SEC
Seth Littrell,35000,580000,0,991416,991416,2017,North Texas,C-USA
Seth Littrell,0,535000,0,815000,815000,2016,North Texas,C-USA
Dan McCarney,0,945000,1600,720000,721600,2015,North Texas,C-USA
Dan McCarney,0,945000,1600,710000,711600,2014,North Texas,C-USA
Dan McCarney,0,85000,300,545000,545300,2013,North Texas,C-USA
Dan McCarney,0,75000,300,545000,545300,2012,North Texas,C-USA
Dan McCarney,0,75000,0,545000,545000,2011,North Texas,C-USA
Todd Dodge,0,101000,0,289161,289161,2010,North Texas,C-USA
Todd Dodge,0,101000,49963,230000,279963,2009,North Texas,C-USA
Todd Dodge,0,82000,31000,230000,261000,2007,North Texas,C-USA
Darrell Dickey,0,92000,34200,232425,266625,2006,North Texas,C-USA
Jay Norvell,0,210000,0,450000,450000,2017,Nevada,Mt. West
Brian Polian,85000,250000,3000,575000,578000,2016,Nevada,Mt. West
Brian Polian,55000,250000,3000,575000,578000,2015,Nevada,Mt. West
Brian Polian,0,250000,0,575000,575000,2014,Nevada,Mt. West
Brian Polian,0,250000,0,525000,525000,2013,Nevada,Mt. West
Chris Ault,0,30000,0,493093,493093,2012,Nevada,Mt. West
Chris Ault,0,30000,0,438952,438952,2011,Nevada,Mt. West
Chris Ault,0,30000,0,443093,443093,2010,Nevada,Mt. West
Chris Ault,0,30000,0,377505,377505,2009,Nevada,Mt. West
Chris Ault,0,30000,0,368092,368092,2007,Nevada,Mt. West
Chris Ault,0,30000,0,360000,360000,2006,Nevada,Mt. West
Bryan Harsin,55000,475000,0,1550004,1550004,2017,Boise State,Mt. West
Bryan Harsin,85000,400000,0,1300004,1300004,2016,Boise State,Mt. West
Bryan Harsin,182875,400000,0,1100004,1100004,2015,Boise State,Mt. West
Bryan Harsin,0,400000,0,1000004,1000004,2014,Boise State,Mt. West
Chris Petersen,0,290000,3500,2148000,2151500,2013,Boise State,Mt. West
Chris Petersen,0,290000,3500,1956333,1959833,2012,Boise State,Mt. West
Chris Petersen,0,170000,0,1525000,1525000,2011,Boise State,Mt. West
Chris Petersen,0,145000,5000,1489053,1494053,2010,Boise State,Mt. West
Chris Petersen,0,227313,127900,995250,1123150,2009,Boise State,Mt. West
Chris Petersen,0,215833,23500,857500,881000,2007,Boise State,Mt. West
Chris Petersen,0,186667,9300,502500,511800,2006,Boise State,Mt. West
Dave Doeren,150000,1750000,0,2212600,2212600,2017,North Carolina State,ACC
Dave Doeren,125000,1750000,0,2200000,2200000,2016,North Carolina State,ACC
Dave Doeren,100000,1750000,0,2200000,2200000,2015,North Carolina State,ACC
Dave Doeren,0,1000000,0,1800000,1800000,2014,North Carolina State,ACC
Dave Doeren,0,1000000,5000,2550000,2555000,2013,North Carolina State,ACC
Tom O'Brien,0,1110000,1000000,936225,1936225,2012,North Carolina State,ACC
Tom O'Brien,0,750000,945000,932950,1877950,2011,North Carolina State,ACC
Tom O'Brien,0,750000,887500,632950,1520450,2010,North Carolina State,ACC
Tom O'Brien,0,700000,575000,625000,1200000,2009,North Carolina State,ACC
Tom O'Brien,0,850000,500000,600000,1100000,2007,North Carolina State,ACC
Chuck Amato,0,0,810000,185000,995000,2006,North Carolina State,ACC
Tony Sanchez,30000,260000,0,600000,600000,2017,UNLV,Mt. West
Tony Sanchez,15000,325000,0,510000,510000,2016,UNLV,Mt. West
Tony Sanchez,0,175000,0,560000,560000,2015,UNLV,Mt. West
Bobby Hauck,0,285000,0,850000,850000,2014,UNLV,Mt. West
Bobby Hauck,0,140000,3749,500000,503749,2013,UNLV,Mt. West
Bobby Hauck,0,140000,900,500000,500900,2012,UNLV,Mt. West
Bobby Hauck,0,140000,1100,500000,501100,2011,UNLV,Mt. West
Bobby Hauck,0,140000,2500,500000,502500,2010,UNLV,Mt. West
Mike Sanford,0,110000,283100,160000,443100,2009,UNLV,Mt. West
Mike Sanford,0,50000,279000,160000,439000,2007,UNLV,Mt. West
Mike Sanford,0,50000,275000,160000,435000,2006,UNLV,Mt. West
Mark Richt,0,0,0,0,0,2017,Miami (FL),ACC
Mark Richt,0,0,0,0,0,2016,Miami (FL),ACC
Al Golden,0,0,0,2539315,2539315,2015,Miami (FL),ACC
Al Golden,0,0,0,2250943,2250943,2014,Miami (FL),ACC
Al Golden,0,0,0,2148107,2148107,2013,Miami (FL),ACC
Al Golden,0,0,0,0,0,2012,Miami (FL),ACC
Al Golden,0,0,0,0,0,2011,Miami (FL),ACC
Randy Shannon,0,0,0,0,0,2010,Miami (FL),ACC
Randy Shannon,0,0,0,0,0,2009,Miami (FL),ACC
Randy Shannon,0,0,0,0,0,2007,Miami (FL),ACC
Larry Coker,0,0,0,1800000,1800000,2006,Miami (FL),ACC
Clay Helton,0,0,0,0,0,2017,USC,Pac-12
Clay Helton,0,0,0,0,0,2016,USC,Pac-12
Steve Sarkisian,0,0,0,0,0,2015,USC,Pac-12
Steve Sarkisian,0,0,0,0,0,2014,USC,Pac-12
Lane Kiffin,0,0,0,2594091,2594091,2013,USC,Pac-12
Lane Kiffin,0,0,0,2406505,2406505,2012,USC,Pac-12
Lane Kiffin,0,0,0,0,0,2011,USC,Pac-12
Lane Kiffin,0,0,0,0,0,2010,USC,Pac-12
Pete Carroll,0,0,0,4386652,4386652,2009,USC,Pac-12
Pete Carroll,0,0,0,2794656,2794656,2007,USC,Pac-12
Pete Carroll,0,0,0,2782320,2782320,2006,USC,Pac-12
Paul Petrino,70000,225000,0,446214,446214,2017,Idaho,Sun Belt
Paul Petrino,10000,152000,0,417104,417104,2016,Idaho,Sun Belt
Paul Petrino,5000,152000,5000,413526,418526,2015,Idaho,Sun Belt
Paul Petrino,0,152000,0,400011,400011,2014,Idaho,Sun Belt
Paul Petrino,0,152000,0,400011,400011,2013,Idaho,Sun Belt
Robb Akey,0,158262,6200,375797,381997,2012,Idaho,Sun Belt
Robb Akey,0,158262,6200,365797,371997,2011,Idaho,Sun Belt
Robb Akey,0,158262,7390,355797,363187,2010,Idaho,Sun Belt
Robb Akey,0,35508,92390,165797,258187,2009,Idaho,Sun Belt
Robb Akey,0,33846,85000,155002,240002,2007,Idaho,Sun Belt
Dennis Erickson,0,27252,70000,144643,214643,2006,Idaho,Sun Belt
Kyle Whittingham,330833,935000,0,3687917,3687917,2017,Utah,Pac-12
Kyle Whittingham,334167,935000,0,3650000,3650000,2016,Utah,Pac-12
Kyle Whittingham,195000,935000,0,2600000,2600000,2015,Utah,Pac-12
Kyle Whittingham,0,740000,0,2200000,2200000,2014,Utah,Pac-12
Kyle Whittingham,0,740000,0,2427100,2427100,2013,Utah,Pac-12
Kyle Whittingham,0,740000,0,2000000,2000000,2012,Utah,Pac-12
Kyle Whittingham,0,740000,0,1700000,1700000,2011,Utah,Pac-12
Kyle Whittingham,0,485000,0,1175000,1175000,2010,Utah,Pac-12
Kyle Whittingham,0,485000,937500,270000,1207500,2009,Utah,Pac-12
Kyle Whittingham,0,350000,467000,211120,678120,2007,Utah,Pac-12
Kyle Whittingham,0,280000,467000,205000,672000,2006,Utah,Pac-12
Bronco Mendenhall,0,2165000,0,3400000,3400000,2017,Virginia,ACC
Bronco Mendenhall,0,2445000,0,3275000,3275000,2016,Virginia,ACC
Mike London,0,715000,1676,3196724,3198400,2015,Virginia,ACC
Mike London,0,715000,5186,2298413,2303599,2014,Virginia,ACC
Mike London,0,715000,16503,2173200,2189703,2013,Virginia,ACC
Mike London,0,715000,3700,2552760,2556460,2012,Virginia,ACC
Mike London,0,715000,14679,1780000,1794679,2011,Virginia,ACC
Mike London,0,715000,0,1780000,1780000,2010,Virginia,ACC
Al Groh,0,940000,1780639,291700,2072339,2009,Virginia,ACC
Al Groh,0,940000,1609650,264600,1874250,2007,Virginia,ACC
Al Groh,0,940000,1533000,252000,1785000,2006,Virginia,ACC
Todd Graham,445000,3906000,8779,3200000,3208779,2017,Arizona State,Pac-12
Todd Graham,375000,3823000,3438,3100000,3103438,2016,Arizona State,Pac-12
Todd Graham,627000,3740000,2960,3000000,3002960,2015,Arizona State,Pac-12
Todd Graham,0,3491000,2960,2700000,2702960,2014,Arizona State,Pac-12
Todd Graham,0,3159000,3020,2300000,2303020,2013,Arizona State,Pac-12
Todd Graham,0,2050000,0,3000000,3000000,2012,Arizona State,Pac-12
Dennis Erickson,0,1800000,3000,1500000,1503000,2011,Arizona State,Pac-12
Dennis Erickson,0,1800000,3000,1500000,1503000,2010,Arizona State,Pac-12
Dennis Erickson,0,1800000,1052643,450000,1502643,2009,Arizona State,Pac-12
Dennis Erickson,0,1195000,50000,450000,500000,2007,Arizona State,Pac-12
Dirk Koetter,0,1234000,41000,950000,991000,2006,Arizona State,Pac-12
Urban Meyer,300000,775000,0,6431240,6431240,2017,Ohio State,Big Ten
Urban Meyer,250000,775000,91800,6003000,6094800,2016,Ohio State,Big Ten
Urban Meyer,400000,775000,0,5860000,5860000,2015,Ohio State,Big Ten
Urban Meyer,0,550000,50000,4486640,4536640,2014,Ohio State,Big Ten
Urban Meyer,0,550000,0,4608000,4608000,2013,Ohio State,Big Ten
Urban Meyer,0,450000,50000,4250000,4300000,2012,Ohio State,Big Ten
Luke Fickell,0,150000,0,1172000,1172000,2011,Ohio State,Big Ten
Jim Tressel,0,450000,376389,3512000,3888389,2010,Ohio State,Big Ten
Jim Tressel,0,450000,2657000,1065000,3722000,2009,Ohio State,Big Ten
Jim Tressel,0,450000,1402000,965000,2367000,2007,Ohio State,Big Ten
Jim Tressel,0,375000,1122700,890000,2012700,2006,Ohio State,Big Ten
Mark Hudspeth,25000,155000,0,1150000,1150000,2017,Louisiana-Lafayette,Sun Belt
Mark Hudspeth,0,155000,0,1100000,1100000,2016,Louisiana-Lafayette,Sun Belt
Mark Hudspeth,45000,155000,3156,1050000,1053156,2015,Louisiana-Lafayette,Sun Belt
Mark Hudspeth,0,155000,3156,1000000,1003156,2014,Louisiana-Lafayette,Sun Belt
Mark Hudspeth,0,105000,3000,800000,803000,2013,Louisiana-Lafayette,Sun Belt
Mark Hudspeth,0,105000,3000,800000,803000,2012,Louisiana-Lafayette,Sun Belt
Mark Hudspeth,0,65000,1000,360000,361000,2011,Louisiana-Lafayette,Sun Belt
Rickey Bustle,0,47500,1000,225000,226000,2010,Louisiana-Lafayette,Sun Belt
Rickey Bustle,0,37794,59240,166760,226000,2009,Louisiana-Lafayette,Sun Belt
Rickey Bustle,0,42375,35000,160750,195750,2007,Louisiana-Lafayette,Sun Belt
Rickey Bustle,0,25417,0,194250,194250,2006,Louisiana-Lafayette,Sun Belt
Butch Davis,0,550000,0,900000,900000,2017,Florida International,C-USA
Ron Turner,25000,150000,1000,609731,610731,2016,Florida International,C-USA
Ron Turner,0,150000,1000,604190,605190,2015,Florida International,C-USA
Ron Turner,0,150000,1000,550000,551000,2014,Florida International,C-USA
Ron Turner,0,120000,0,500000,500000,2013,Florida International,C-USA
Mario Cristobal,0,145000,0,522183,522183,2012,Florida International,C-USA
Mario Cristobal,0,50000,0,497183,497183,2011,Florida International,C-USA
Mario Cristobal,0,50000,0,437382,437382,2010,Florida International,C-USA
Mario Cristobal,0,50000,0,403000,403000,2009,Florida International,C-USA
Mario Cristobal,0,50000,0,381076,381076,2007,Florida International,C-USA
Don Strock,0,0,32100,250000,282100,2006,Florida International,C-USA
Jeff Brohm,0,1200000,0,3333333,3333333,2017,Purdue,Big Ten
Darrell Hazell,120000,1545000,0,2190000,2190000,2016,Purdue,Big Ten
Darrell Hazell,90000,1545000,0,2140000,2140000,2015,Purdue,Big Ten
Darrell Hazell,0,1545000,0,2090000,2090000,2014,Purdue,Big Ten
Darrell Hazell,0,1095000,0,2160833,2160833,2013,Purdue,Big Ten
Danny Hope,0,778904,0,970000,970000,2012,Purdue,Big Ten
Danny Hope,0,725738,0,925000,925000,2011,Purdue,Big Ten
Danny Hope,0,637250,0,900000,900000,2010,Purdue,Big Ten
Danny Hope,0,558900,335000,490000,825000,2009,Purdue,Big Ten
Joe Tiller,0,0,1522256,242550,1764806,2007,Purdue,Big Ten
Joe Tiller,0,0,986742,231000,1217742,2006,Purdue,Big Ten
Tyson Summers,0,292500,0,530000,530000,2017,Georgia Southern,Sun Belt
Tyson Summers,0,292500,0,500000,500000,2016,Georgia Southern,Sun Belt
Willie Fritz,35000,287500,0,500000,500000,2015,Georgia Southern,Sun Belt
Willie Fritz,0,42500,0,400000,400000,2014,Georgia Southern,Sun Belt
Nick Rolovich,60000,1260000,2094,400008,402102,2017,Hawaii,Mt. West
Nick Rolovich,0,1260000,0,400008,400008,2016,Hawaii,Mt. West
Norm Chow,0,1180000,87750,550000,637750,2015,Hawaii,Mt. West
Norm Chow,0,1180000,70500,550000,620500,2014,Hawaii,Mt. West
Norm Chow,0,880000,70000,550000,620000,2013,Hawaii,Mt. West
Norm Chow,0,695000,0,550000,550000,2012,Hawaii,Mt. West
Greg McMackin,0,130000,15000,1100004,1115004,2011,Hawaii,Mt. West
Greg McMackin,0,160000,13000,1100004,1113004,2010,Hawaii,Mt. West
Greg McMackin,0,130000,38500,1100004,1138504,2009,Hawaii,Mt. West
June Jones,0,130000,400008,400008,800016,2007,Hawaii,Mt. West
June Jones,0,130000,420000,400008,820008,2006,Hawaii,Mt. West
Mark Stoops,425000,3100000,13600,3750000,3763600,2017,Kentucky,SEC
Mark Stoops,50000,2800000,13600,3500000,3513600,2016,Kentucky,SEC
Mark Stoops,125000,2775000,13600,3250000,3263600,2015,Kentucky,SEC
Mark Stoops,0,1475000,1600,2700000,2701600,2014,Kentucky,SEC
Mark Stoops,0,1475000,0,2001250,2001250,2013,Kentucky,SEC
Joker Phillips,0,1105000,4250,1700000,1704250,2012,Kentucky,SEC
Joker Phillips,0,1105000,1150,1701339,1702489,2011,Kentucky,SEC
Joker Phillips,0,1105000,6600,1700000,1706600,2010,Kentucky,SEC
Rich Brooks,0,1095000,1217517,400000,1617517,2009,Kentucky,SEC
Rich Brooks,0,605000,761800,294884,1056684,2007,Kentucky,SEC
Rich Brooks,0,85000,534165,195000,729165,2006,Kentucky,SEC
James Franklin,900000,1000000,0,4600000,4600000,2017,Penn State,Big Ten
James Franklin,200000,1000000,0,4500000,4500000,2016,Penn State,Big Ten
James Franklin,200000,1000000,0,4400000,4400000,2015,Penn State,Big Ten
James Franklin,0,1000000,0,4300000,4300000,2014,Penn State,Big Ten
Bill O'Brien,0,200000,0,3282779,3282779,2013,Penn State,Big Ten
Bill O'Brien,0,47500,0,2300000,2300000,2012,Penn State,Big Ten
Joe Paterno,0,0,0,1022794,1022794,2011,Penn State,Big Ten
Joe Paterno,0,0,0,1109977,1109977,2010,Penn State,Big Ten
Joe Paterno,0,0,0,1097767,1097767,2009,Penn State,Big Ten
Joe Paterno,0,0,0,512664,512664,2007,Penn State,Big Ten
Joe Paterno,0,0,0,0,0,2006,Penn State,Big Ten
Mike Riley,150000,950000,0,2900000,2900000,2017,Nebraska,Big Ten
Mike Riley,0,950000,0,2800000,2800000,2016,Nebraska,Big Ten
Mike Riley,0,950000,0,2700000,2700000,2015,Nebraska,Big Ten
Bo Pelini,0,1000000,0,3077646,3077646,2014,Nebraska,Big Ten
Bo Pelini,0,1000000,0,2975000,2975000,2013,Nebraska,Big Ten
Bo Pelini,0,1000000,0,2875000,2875000,2012,Nebraska,Big Ten
Bo Pelini,0,1000000,0,2775000,2775000,2011,Nebraska,Big Ten
Bo Pelini,0,550000,0,2100000,2100000,2010,Nebraska,Big Ten
Bo Pelini,0,550000,0,1852000,1852000,2009,Nebraska,Big Ten
Bill Callahan,0,425000,1025000,726250,1751250,2007,Nebraska,Big Ten
Bill Callahan,0,113547,0,1690317,1690317,2006,Nebraska,Big Ten
Doug Martin,0,135000,0,376044,376044,2017,New Mexico State,Sun Belt
Doug Martin,0,135000,0,376044,376044,2016,New Mexico State,Sun Belt
Doug Martin,0,135000,1000,376044,377044,2015,New Mexico State,Sun Belt
Doug Martin,0,185000,1000,376044,377044,2014,New Mexico State,Sun Belt
Doug Martin,0,185000,0,375000,375000,2013,New Mexico State,Sun Belt
DeWayne Walker,0,185000,0,382260,382260,2012,New Mexico State,Sun Belt
DeWayne Walker,0,185000,0,375000,375000,2011,New Mexico State,Sun Belt
DeWayne Walker,0,185000,0,375000,375000,2010,New Mexico State,Sun Belt
DeWayne Walker,0,185000,0,375000,375000,2009,New Mexico State,Sun Belt
Hal Mumme,0,205000,110600,238320,348920,2007,New Mexico State,Sun Belt
Hal Mumme,0,165000,54800,229000,283800,2006,New Mexico State,Sun Belt
Paul Chryst,260000,0,0,3200000,3200000,2017,Wisconsin,Big Ten
Paul Chryst,100000,440000,6200,2700000,2706200,2016,Wisconsin,Big Ten
Paul Chryst,0,440000,0,2300000,2300000,2015,Wisconsin,Big Ten
Gary Andersen,0,440000,85000,2200000,2285000,2014,Wisconsin,Big Ten
Gary Andersen,0,440000,85000,2035823,2120823,2013,Wisconsin,Big Ten
Bret Bielema,0,400000,40140,2600000,2640140,2012,Wisconsin,Big Ten
Bret Bielema,0,400000,98186,2500000,2598186,2011,Wisconsin,Big Ten
Bret Bielema,0,350000,81759,1700000,1781759,2010,Wisconsin,Big Ten
Bret Bielema,0,350000,1081506,400000,1481506,2009,Wisconsin,Big Ten
Bret Bielema,0,350000,94638,1300000,1394638,2007,Wisconsin,Big Ten
Bret Bielema,0,175000,11600,750000,761600,2006,Wisconsin,Big Ten
Nick Saban,550000,700000,0,11132000,11132000,2017,Alabama,SEC
Nick Saban,625000,700000,0,6939395,6939395,2016,Alabama,SEC
Nick Saban,425000,700000,155086,6932395,7087481,2015,Alabama,SEC
Nick Saban,0,700000,209984,6950203,7160187,2014,Alabama,SEC
Nick Saban,0,700000,150000,5395852,5545852,2013,Alabama,SEC
Nick Saban,0,700000,160071,5316667,5476738,2012,Alabama,SEC
Nick Saban,0,700000,150000,4683333,4833333,2011,Alabama,SEC
Nick Saban,0,700000,830683,5166666,5997349,2010,Alabama,SEC
Nick Saban,0,700000,3675000,225000,3900000,2009,Alabama,SEC
Nick Saban,0,700000,3278200,225000,3503200,2007,Alabama,SEC
Mike Shula,0,875000,1354853,412000,1766853,2006,Alabama,SEC
Mike Sanford Jr.,0,400000,0,800000,800000,2017,Western Kentucky,C-USA
Jeff Brohm,150000,450000,3120,805600,808720,2016,Western Kentucky,C-USA
Jeff Brohm,100000,450000,3120,610800,613920,2015,Western Kentucky,C-USA
Jeff Brohm,0,550000,0,600000,600000,2014,Western Kentucky,C-USA
Bobby Petrino,0,355000,0,855600,855600,2013,Western Kentucky,C-USA
Willie Taggart,0,168750,4800,475000,479800,2012,Western Kentucky,C-USA
Willie Taggart,0,144750,0,225000,225000,2011,Western Kentucky,C-USA
Willie Taggart,0,144750,0,225000,225000,2010,Western Kentucky,C-USA
David Elson,0,152838,9800,250008,259808,2009,Western Kentucky,C-USA
David Elson,0,94498,4600,175000,179600,2007,Western Kentucky,C-USA
Major Applewhite,0,782500,0,1750000,1750000,2017,Houston,AAC
Tom Herman,137500,447500,3500,3000000,3003500,2016,Houston,AAC
Tom Herman,0,447500,0,1450000,1450000,2015,Houston,AAC
Tony Levine,0,422500,300,1025000,1025300,2014,Houston,AAC
Tony Levine,0,340000,2100,900000,902100,2013,Houston,AAC
Tony Levine,0,370000,0,900000,900000,2012,Houston,AAC
Kevin Sumlin,0,500000,0,1200000,1200000,2011,Houston,AAC
Kevin Sumlin,0,500000,0,1000000,1000000,2010,Houston,AAC
Kevin Sumlin,0,325000,400000,350000,750000,2009,Houston,AAC
Art Briles,0,275000,550000,380000,930000,2007,Houston,AAC
Art Briles,0,190000,300000,250000,550000,2006,Houston,AAC
Jeff Tedford,0,2765000,0,1550000,1550000,2017,Fresno State,Mt. West
Tim DeRuyter,245000,1685000,30000,1518480,1548480,2016,Fresno State,Mt. West
Tim DeRuyter,420000,1685000,35000,1457745,1492745,2015,Fresno State,Mt. West
Tim DeRuyter,0,1685000,35000,1400000,1435000,2014,Fresno State,Mt. West
Tim DeRuyter,0,1685000,5000,650000,655000,2013,Fresno State,Mt. West
Tim DeRuyter,0,1610000,0,650000,650000,2012,Fresno State,Mt. West
Pat Hill,0,870000,29000,650000,679000,2011,Fresno State,Mt. West
Pat Hill,0,697167,46810,952499,999309,2010,Fresno State,Mt. West
Pat Hill,0,651583,338506,625000,963506,2009,Fresno State,Mt. West
Pat Hill,0,0,545760,684236,1229996,2007,Fresno State,Mt. West
Pat Hill,0,0,22561,1231421,1253982,2006,Fresno State,Mt. West
Tim Lester,0,322000,0,800000,800000,2017,Western Michigan,MAC
P.J. Fleck,128500,336000,4000,816360,820360,2016,Western Michigan,MAC
P.J. Fleck,78750,336000,2500,800000,802500,2015,Western Michigan,MAC
P.J. Fleck,0,236000,0,392500,392500,2014,Western Michigan,MAC
P.J. Fleck,0,236000,0,392500,392500,2013,Western Michigan,MAC
Bill Cubit,0,251500,2000,377250,379250,2012,Western Michigan,MAC
Bill Cubit,0,251500,2000,377250,379250,2011,Western Michigan,MAC
Bill Cubit,0,251500,2000,375000,377000,2010,Western Michigan,MAC
Bill Cubit,0,223000,154000,225000,379000,2009,Western Michigan,MAC
Bill Cubit,0,222000,75000,191000,266000,2007,Western Michigan,MAC
Bill Cubit,0,21450,23000,165000,188000,2006,Western Michigan,MAC
Bill Snyder,50000,580000,5000,3200000,3205000,2017,Kansas State,Big 12
Bill Snyder,50000,580000,6000,3100000,3106000,2016,Kansas State,Big 12
Bill Snyder,150000,580000,0,3000000,3000000,2015,Kansas State,Big 12
Bill Snyder,0,580000,0,2900000,2900000,2014,Kansas State,Big 12
Bill Snyder,0,580000,3000,2800000,2803000,2013,Kansas State,Big 12
Bill Snyder,0,455000,0,2200000,2200000,2012,Kansas State,Big 12
Bill Snyder,0,455000,0,1925000,1925000,2011,Kansas State,Big 12
Bill Snyder,0,455000,0,1875000,1875000,2010,Kansas State,Big 12
Bill Snyder,0,455000,308333,1541667,1850000,2009,Kansas State,Big 12
Ron Prince,0,250000,612000,142142,754142,2007,Kansas State,Big 12
Ron Prince,0,250000,612000,138000,750000,2006,Kansas State,Big 12
Butch Jones,250000,1000000,0,4110000,4110000,2017,Tennessee,SEC
Butch Jones,350000,1000000,0,4110000,4110000,2016,Tennessee,SEC
Butch Jones,300000,1000000,23000,3610000,3633000,2015,Tennessee,SEC
Butch Jones,0,1000000,0,2960000,2960000,2014,Tennessee,SEC
Butch Jones,0,1000000,0,4860000,4860000,2013,Tennessee,SEC
Derek Dooley,0,475000,11000,2000000,2011000,2012,Tennessee,SEC
Derek Dooley,0,475000,37200,2293391,2330591,2011,Tennessee,SEC
Derek Dooley,0,475000,3000,2118391,2121391,2010,Tennessee,SEC
Lane Kiffin,0,540000,1650000,350000,2000000,2009,Tennessee,SEC
Phillip Fulmer,0,250000,1725000,325000,2050000,2007,Tennessee,SEC
Phillip Fulmer,0,250000,1725000,325000,2050000,2006,Tennessee,SEC
Kliff Kingsbury,90000,1500000,0,3503975,3503975,2017,Texas Tech,Big 12
Kliff Kingsbury,50000,1500000,0,3306575,3306575,2016,Texas Tech,Big 12
Kliff Kingsbury,70000,1500000,39500,3108000,3147500,2015,Texas Tech,Big 12
Kliff Kingsbury,0,1500000,300,2605000,2605300,2014,Texas Tech,Big 12
Kliff Kingsbury,0,600000,300,1855000,1855300,2013,Texas Tech,Big 12
Tommy Tuberville,0,1025000,5000,2150000,2155000,2012,Texas Tech,Big 12
Tommy Tuberville,0,1025000,9000,2050000,2059000,2011,Texas Tech,Big 12
Tommy Tuberville,0,1025000,9000,1500000,1509000,2010,Texas Tech,Big 12
Mike Leach,0,650000,1600000,1100000,2700000,2009,Texas Tech,Big 12
Mike Leach,0,325000,1361500,300000,1661500,2007,Texas Tech,Big 12
Mike Leach,0,375000,1300000,300000,1600000,2006,Texas Tech,Big 12
