coach,last_year_bonus,max_bonus,other_pay,position,school_name,school_pay,total_pay,year
Mark Dantonio,0.0,650000,10000,coach,Michigan State,4380492,4390492,2017
Mark Dantonio,475000.0,650000,0,coach,Michigan State,4300000,4300000,2016
Mark Dantonio,475000.0,650000,0,HC,Michigan State,4300000,4300000,2016
Mark Dantonio,250000.0,650000,0,coach,Michigan State,3671520,3671520,2015
Mark Dantonio,0.0,650000,24300,coach,Michigan State,5611845,5636145,2014
Mark Dantonio,0.0,650000,24300,HC,Michigan State,5611845,5636145,2014
Mark Dantonio,0.0,650000,0,coach,Michigan State,1959744,1959744,2013
Mark Dantonio,0.0,650000,0,coach,Michigan State,1934250,1934250,2012
Mark Dantonio,0.0,650000,0,coach,Michigan State,1918000,1918000,2011
Mark Dantonio,0.0,650000,0,HC,Michigan State,1918000,1918000,2011
Mark Dantonio,0.0,660000,0,coach,Michigan State,1796700,1796700,2010
Mark Dantonio,0.0,725000,984000,coach,Michigan State,827260,1811260,2009
Mark Dantonio,0.0,725000,984000,HC,Michigan State,827260,1811260,2009
Mark Dantonio,0.0,650000,550000,coach,Michigan State,600000,1150000,2007
Mark Dantonio,0.0,701667,225000,coach,Cincinnati,270000,495000,2006
Blake Anderson,50000.0,185000,0,coach,Arkansas State,750000,750000,2017
Blake Anderson,50000.0,235000,0,coach,Arkansas State,700000,700000,2016
Blake Anderson,25000.0,235000,0,coach,Arkansas State,700000,700000,2015
Blake Anderson,0.0,235000,0,coach,Arkansas State,700000,700000,2014
Blake Anderson,0.0,235000,0,HC,Arkansas State,700000,700000,2014
Blake Anderson,0.0,20833,0,assistant,North Carolina,250000,250000,2013
Blake Anderson,0.0,20833,0,assistant,North Carolina,250000,250000,2012
Blake Anderson,0.0,13750,2000,assistant,Southern Miss,165000,167000,2011
Blake Anderson,0.0,0,2000,assistant,Southern Miss,115000,117000,2010
Blake Anderson,0.0,8750,2000,assistant,Southern Miss,105000,107000,2009
Bobby Wilder,10000.0,504506,0,coach,Old Dominion,650000,650000,2017
Bobby Wilder,0.0,504506,15000,coach,Old Dominion,554590,569590,2016
Bobby Wilder,0.0,504125,15000,coach,Old Dominion,550000,565000,2015
Bobby Wilder,0.0,504125,15000,HC,Old Dominion,550000,565000,2015
Bobby Wilder,0.0,503333,11010,coach,Old Dominion,475000,486010,2014
Bobby Wilder,0.0,0,0,coach,Old Dominion,450000,450000,2013
Brad Lambert,0.0,120000,0,coach,Charlotte,625000,625000,2017
Brad Lambert,0.0,120000,0,coach,Charlotte,600000,600000,2016
Brad Lambert,0.0,120000,0,coach,Charlotte,600000,600000,2015
Brad Lambert,0.0,0,0,assistant,Wake Forest,0,0,2010
Brad Lambert,0.0,0,0,assistant,Wake Forest,0,0,2009
Derek Mason,0.0,0,0,coach,Vanderbilt,2721834,2721834,2017
Derek Mason,0.0,0,0,coach,Vanderbilt,2556877,2556877,2016
Derek Mason,0.0,0,0,coach,Vanderbilt,0,0,2015
Derek Mason,0.0,0,0,coach,Vanderbilt,0,0,2014
Derek Mason,0.0,0,0,assistant,Stanford,0,0,2013
Derek Mason,0.0,0,0,assistant,Stanford,0,0,2012
Derek Mason,0.0,0,0,assistant,Stanford,0,0,2011
Derek Mason,0.0,0,0,AC,Stanford,0,0,2010
Derek Mason,0.0,0,0,assistant,Stanford,0,0,2010
Jim Harbaugh,200000.0,1325000,0,coach,Michigan,7004000,7004000,2017
Jim Harbaugh,0.0,1325000,0,coach,Michigan,9004000,9004000,2016
Jim Harbaugh,0.0,1325000,0,HC,Michigan,9004000,9004000,2016
Jim Harbaugh,0.0,1175000,0,coach,Michigan,7004000,7004000,2015
Jim Harbaugh,0.0,0,0,coach,Stanford,0,0,2010
Jim Harbaugh,0.0,0,0,coach,Stanford,0,0,2009
Jim Harbaugh,0.0,0,0,coach,Stanford,0,0,2007
Chris Petersen,675000.0,1050000,2500,coach,Washington,4125000,4127500,2017
Chris Petersen,675000.0,1050000,2500,HC,Washington,4125000,4127500,2017
Chris Petersen,150000.0,1175000,5847,coach,Washington,3600000,3605847,2016
Chris Petersen,200000.0,1175000,2940,coach,Washington,3400000,3402940,2015
Chris Petersen,0.0,1175000,0,coach,Washington,3681720,3681720,2014
Chris Petersen,0.0,290000,3500,coach,Boise State,2148000,2151500,2013
Chris Petersen,0.0,290000,3500,coach,Boise State,1956333,1959833,2012
Chris Petersen,0.0,170000,0,coach,Boise State,1525000,1525000,2011
Chris Petersen,0.0,145000,5000,coach,Boise State,1489053,1494053,2010
Chris Petersen,0.0,145000,5000,HC,Boise State,1489053,1494053,2010
Chris Petersen,0.0,227313,127900,coach,Boise State,995250,1123150,2009
Chris Petersen,0.0,227313,127900,HC,Boise State,995250,1123150,2009
Chris Petersen,0.0,215833,23500,coach,Boise State,857500,881000,2007
Chris Petersen,0.0,186667,9300,coach,Boise State,502500,511800,2006
Chris Petersen,0.0,186667,9300,HC,Boise State,502500,511800,2006
Dana Holgorsen,185000.0,750000,0,coach,West Virginia,3505000,3505000,2017
Dana Holgorsen,60000.0,600000,0,coach,West Virginia,2980000,2980000,2016
Dana Holgorsen,35000.0,600000,0,coach,West Virginia,2880000,2880000,2015
Dana Holgorsen,35000.0,600000,0,HC,West Virginia,2880000,2880000,2015
Dana Holgorsen,0.0,600000,0,coach,West Virginia,3080000,3080000,2014
Dana Holgorsen,0.0,600000,0,coach,West Virginia,2630000,2630000,2013
Dana Holgorsen,0.0,600000,0,coach,West Virginia,2380000,2380000,2012
Dana Holgorsen,0.0,600000,0,coach,West Virginia,1490000,1490000,2011
Dana Holgorsen,0.0,0,0,assistant,Oklahoma State,360000,360000,2010
Dana Holgorsen,0.0,66200,0,assistant,Houston,187200,187200,2009
Mark Whipple,0.0,255000,250,coach,Massachusetts,472654,472904,2017
Mark Whipple,10000.0,295000,1250,coach,Massachusetts,467965,469215,2016
Mark Whipple,0.0,200000,6000,coach,Massachusetts,450000,456000,2015
Mark Whipple,0.0,200000,0,coach,Massachusetts,450000,450000,2014
Mark Whipple,0.0,0,0,assistant,Miami (FL),0,0,2010
Mark Whipple,0.0,0,0,assistant,Miami (FL),0,0,2009
Dave Clawson,0.0,0,0,coach,Wake Forest,1827370,1827370,2017
Dave Clawson,0.0,0,0,coach,Wake Forest,2113166,2113166,2016
Dave Clawson,0.0,0,0,coach,Wake Forest,0,0,2015
Dave Clawson,0.0,0,0,coach,Wake Forest,0,0,2014
Dave Clawson,0.0,109000,1000,coach,Bowling Green,400000,401000,2013
Dave Clawson,0.0,116000,1200,coach,Bowling Green,363000,364200,2012
Dave Clawson,0.0,111000,1200,coach,Bowling Green,363000,364200,2011
Dave Clawson,0.0,98000,1000,coach,Bowling Green,205000,206000,2010
Dave Clawson,0.0,100000,86000,coach,Bowling Green,215000,301000,2009
Dave Clawson,0.0,100000,86000,HC,Bowling Green,215000,301000,2009
Frank Solich,35386.0,331930,0,coach,Ohio,522715,522715,2017
Frank Solich,10000.0,331930,0,coach,Ohio,572715,572715,2016
Frank Solich,0.0,329440,1500,coach,Ohio,562760,564260,2015
Frank Solich,0.0,327000,1500,coach,Ohio,553000,554500,2014
Frank Solich,0.0,299350,11500,coach,Ohio,502400,513900,2013
Frank Solich,0.0,297500,11500,coach,Ohio,500000,511500,2012
Frank Solich,0.0,288325,11250,coach,Ohio,465099,476349,2011
Frank Solich,0.0,288325,11250,HC,Ohio,465099,476349,2011
Frank Solich,0.0,288325,2500,coach,Ohio,458300,460800,2010
Frank Solich,0.0,287500,71000,coach,Ohio,385000,456000,2009
Frank Solich,0.0,190006,11900,coach,Ohio,257162,269062,2007
Frank Solich,0.0,162400,12500,coach,Ohio,249672,262172,2006
Tom Allen,0.0,1441668,0,coach,Indiana,1830000,1830000,2017
Tom Allen,0.0,62777,0,assistant,Indiana,501000,501000,2016
Tom Allen,0.0,0,0,assistant,South Florida,350000,350000,2015
Tom Allen,0.0,0,0,AC,Ole Miss,230000,230000,2014
Tom Allen,0.0,0,0,assistant,Ole Miss,230000,230000,2014
Tom Allen,0.0,0,10000,AC,Ole Miss,210000,220000,2013
Tom Allen,0.0,0,10000,assistant,Ole Miss,210000,220000,2013
Tom Allen,0.0,16000,0,assistant,Ole Miss,200000,200000,2012
Tom Allen,0.0,0,2000,AC,Arkansas State,65000,67000,2011
Tom Allen,0.0,0,2000,assistant,Arkansas State,65000,67000,2011
Luke Fickell,0.0,625000,0,coach,Cincinnati,1900000,1900000,2017
Luke Fickell,0.0,625000,0,HC,Cincinnati,1900000,1900000,2017
Luke Fickell,0.0,286875,0,assistant,Ohio State,754500,754500,2016
Luke Fickell,0.0,244800,0,assistant,Ohio State,640000,640000,2015
Luke Fickell,0.0,225000,0,assistant,Ohio State,600000,600000,2014
Luke Fickell,0.0,225000,5000,assistant,Ohio State,605000,610000,2013
Luke Fickell,0.0,187500,5000,assistant,Ohio State,756000,761000,2012
Luke Fickell,0.0,150000,0,coach,Ohio State,1172000,1172000,2011
Luke Fickell,0.0,42932,0,assistant,Ohio State,257600,257600,2010
Luke Fickell,0.0,41667,0,assistant,Ohio State,250000,250000,2009
Bryan Harsin,55000.0,475000,0,coach,Boise State,1550004,1550004,2017
Bryan Harsin,85000.0,400000,0,coach,Boise State,1300004,1300004,2016
Bryan Harsin,182875.0,400000,0,coach,Boise State,1100004,1100004,2015
Bryan Harsin,0.0,400000,0,coach,Boise State,1000004,1000004,2014
Bryan Harsin,0.0,400000,0,HC,Boise State,1000004,1000004,2014
Bryan Harsin,0.0,245000,0,coach,Arkansas State,724597,724597,2013
Bryan Harsin,0.0,122150,0,assistant,Texas,700000,700000,2012
Bryan Harsin,0.0,115400,0,assistant,Texas,625000,625000,2011
Bryan Harsin,0.0,8000,0,assistant,Boise State,259520,259520,2010
Bryan Harsin,0.0,28351,33333,AC,Boise State,190133,223466,2009
Bryan Harsin,0.0,28351,33333,assistant,Boise State,190133,223466,2009
DJ Durkin,25000.0,625000,0,coach,Maryland,2462000,2462000,2017
DJ Durkin,0.0,625000,0,coach,Maryland,2412000,2412000,2016
DJ Durkin,0.0,133333,0,assistant,Michigan,880000,880000,2015
DJ Durkin,0.0,197500,500,AC,Florida,500000,500500,2014
DJ Durkin,0.0,197500,500,assistant,Florida,500000,500500,2014
DJ Durkin,0.0,197500,500,assistant,Florida,500000,500500,2013
DJ Durkin,0.0,136000,0,assistant,Florida,350000,350000,2012
DJ Durkin,0.0,106000,0,assistant,Florida,275000,275000,2011
DJ Durkin,0.0,96000,0,assistant,Florida,250000,250000,2010
DJ Durkin,0.0,0,0,AC,Stanford,0,0,2009
DJ Durkin,0.0,0,0,assistant,Stanford,0,0,2009
P.J. Fleck,0.0,900000,0,coach,Minnesota,3500000,3500000,2017
P.J. Fleck,128500.0,336000,4000,coach,Western Michigan,816360,820360,2016
P.J. Fleck,78750.0,336000,2500,coach,Western Michigan,800000,802500,2015
P.J. Fleck,0.0,236000,0,coach,Western Michigan,392500,392500,2014
P.J. Fleck,0.0,236000,0,coach,Western Michigan,392500,392500,2013
P.J. Fleck,0.0,42500,7000,assistant,Rutgers,170000,177000,2011
P.J. Fleck,0.0,33750,1400,assistant,Rutgers,135000,136400,2010
P.J. Fleck,0.0,16668,300,assistant,Northern Illinois,70008,70308,2009
Nick Saban,550000.0,700000,0,coach,Alabama,11132000,11132000,2017
Nick Saban,550000.0,700000,0,HC,Alabama,11132000,11132000,2017
Nick Saban,625000.0,700000,0,coach,Alabama,6939395,6939395,2016
Nick Saban,425000.0,700000,155086,coach,Alabama,6932395,7087481,2015
Nick Saban,0.0,700000,209984,coach,Alabama,6950203,7160187,2014
Nick Saban,0.0,700000,150000,coach,Alabama,5395852,5545852,2013
Nick Saban,0.0,700000,150000,HC,Alabama,5395852,5545852,2013
Nick Saban,0.0,700000,160071,coach,Alabama,5316667,5476738,2012
Nick Saban,0.0,700000,150000,coach,Alabama,4683333,4833333,2011
Nick Saban,0.0,700000,830683,coach,Alabama,5166666,5997349,2010
Nick Saban,0.0,700000,3675000,coach,Alabama,225000,3900000,2009
Nick Saban,0.0,700000,3675000,HC,Alabama,225000,3900000,2009
Nick Saban,0.0,700000,3278200,coach,Alabama,225000,3503200,2007
Urban Meyer,300000.0,775000,0,coach,Ohio State,6431240,6431240,2017
Urban Meyer,250000.0,775000,91800,coach,Ohio State,6003000,6094800,2016
Urban Meyer,400000.0,775000,0,coach,Ohio State,5860000,5860000,2015
Urban Meyer,0.0,550000,50000,coach,Ohio State,4486640,4536640,2014
Urban Meyer,0.0,550000,0,coach,Ohio State,4608000,4608000,2013
Urban Meyer,0.0,450000,50000,coach,Ohio State,4250000,4300000,2012
Urban Meyer,0.0,575000,0,coach,Florida,4010000,4010000,2010
Urban Meyer,0.0,0,3750000,coach,Florida,250000,4000000,2009
Urban Meyer,0.0,0,3144798,coach,Florida,238702,3383500,2007
Urban Meyer,0.0,454000,1032800,coach,Florida,491750,1524550,2006
Mark Stoops,425000.0,3100000,13600,coach,Kentucky,3750000,3763600,2017
Mark Stoops,425000.0,3100000,13600,HC,Kentucky,3750000,3763600,2017
Mark Stoops,50000.0,2800000,13600,coach,Kentucky,3500000,3513600,2016
Mark Stoops,50000.0,2800000,13600,HC,Kentucky,3500000,3513600,2016
Mark Stoops,125000.0,2775000,13600,coach,Kentucky,3250000,3263600,2015
Mark Stoops,0.0,1475000,1600,coach,Kentucky,2700000,2701600,2014
Mark Stoops,0.0,1475000,1600,HC,Kentucky,2700000,2701600,2014
Mark Stoops,0.0,1475000,0,coach,Kentucky,2001250,2001250,2013
Mark Stoops,0.0,37179,10000,assistant,Florida State,581150,591150,2012
Mark Stoops,0.0,37179,10000,assistant,Florida State,446150,456150,2011
Mark Stoops,0.0,23654,0,assistant,Florida State,400000,400000,2010
Mark Stoops,0.0,0,2900,assistant,Arizona,281014,283914,2009
Barry Odom,162500.0,1025000,0,coach,Missouri,2350000,2350000,2017
Barry Odom,0.0,1025000,0,coach,Missouri,2350000,2350000,2016
Barry Odom,0.0,213750,0,assistant,Missouri,625000,625000,2015
Barry Odom,0.0,31009,0,assistant,Memphis,372113,372113,2014
Barry Odom,0.0,26009,0,assistant,Memphis,312113,312113,2013
Barry Odom,0.0,25000,0,assistant,Memphis,300000,300000,2012
Barry Odom,0.0,69083,0,AC,Missouri,201000,201000,2011
Barry Odom,0.0,69083,0,assistant,Missouri,201000,201000,2011
Barry Odom,0.0,69084,10800,AC,Missouri,191000,201800,2010
Barry Odom,0.0,69084,10800,assistant,Missouri,191000,201800,2010
Barry Odom,0.0,63667,10800,AC,Missouri,191000,201800,2009
Barry Odom,0.0,63667,10800,assistant,Missouri,191000,201800,2009
Paul Chryst,260000.0,0,0,coach,Wisconsin,3200000,3200000,2017
Paul Chryst,100000.0,440000,6200,coach,Wisconsin,2700000,2706200,2016
Paul Chryst,0.0,440000,0,coach,Wisconsin,2300000,2300000,2015
Paul Chryst,0.0,0,0,coach,Pittsburgh,1578757,1578757,2014
Paul Chryst,0.0,0,0,coach,Pittsburgh,0,0,2013
Paul Chryst,0.0,0,0,coach,Pittsburgh,0,0,2012
Paul Chryst,0.0,91500,1750,assistant,Wisconsin,405000,406750,2011
Paul Chryst,0.0,122500,675,assistant,Wisconsin,360419,361094,2010
Paul Chryst,0.0,105000,11554,assistant,Wisconsin,350000,361554,2009
Gary Andersen,50000.0,525000,0,coach,Oregon State,2650000,2650000,2017
Gary Andersen,0.0,525000,0,coach,Oregon State,2550000,2550000,2016
Gary Andersen,0.0,525000,0,coach,Oregon State,2450000,2450000,2015
Gary Andersen,0.0,440000,85000,coach,Wisconsin,2200000,2285000,2014
Gary Andersen,0.0,440000,85000,coach,Wisconsin,2035823,2120823,2013
Gary Andersen,0.0,440000,85000,HC,Wisconsin,2035823,2120823,2013
Gary Andersen,0.0,150000,0,coach,Utah State,415000,415000,2012
Gary Andersen,0.0,45000,2000,coach,Utah State,352400,354400,2011
Gary Andersen,0.0,45000,2000,coach,Utah State,352400,354400,2010
Gary Andersen,0.0,45000,50000,coach,Utah State,302400,352400,2009
Paul Petrino,70000.0,225000,0,coach,Idaho,446214,446214,2017
Paul Petrino,70000.0,225000,0,HC,Idaho,446214,446214,2017
Paul Petrino,10000.0,152000,0,coach,Idaho,417104,417104,2016
Paul Petrino,5000.0,152000,5000,coach,Idaho,413526,418526,2015
Paul Petrino,0.0,152000,0,coach,Idaho,400011,400011,2014
Paul Petrino,0.0,152000,0,coach,Idaho,400011,400011,2013
Paul Petrino,0.0,141667,0,assistant,Arkansas,425000,425000,2012
Paul Petrino,0.0,45500,0,assistant,Illinois,525000,525000,2011
Paul Petrino,0.0,39000,250,assistant,Illinois,475000,475250,2010
Paul Petrino,0.0,25000,8000,AC,Arkansas,300000,308000,2009
Paul Petrino,0.0,25000,8000,assistant,Arkansas,300000,308000,2009
Seth Littrell,35000.0,580000,0,coach,North Texas,991416,991416,2017
Seth Littrell,0.0,535000,0,coach,North Texas,815000,815000,2016
Seth Littrell,0.0,535000,0,HC,North Texas,815000,815000,2016
Seth Littrell,0.0,20917,0,assistant,North Carolina,251000,251000,2015
Seth Littrell,0.0,20833,0,assistant,North Carolina,250000,250000,2014
Seth Littrell,0.0,0,0,assistant,Indiana,356500,356500,2013
Seth Littrell,0.0,0,0,assistant,Indiana,255500,255500,2012
Seth Littrell,0.0,15417,3500,assistant,Arizona,185000,188500,2011
Seth Littrell,0.0,15417,3500,assistant,Arizona,185000,188500,2010
Seth Littrell,0.0,0,0,assistant,Arizona,160000,160000,2009
Mark Richt,0.0,0,0,coach,Miami (FL),0,0,2017
Mark Richt,0.0,0,0,HC,Miami (FL),0,0,2017
Mark Richt,0.0,0,0,coach,Miami (FL),0,0,2016
Mark Richt,75000.0,1800000,124000,coach,Georgia,4000000,4124000,2015
Mark Richt,0.0,1000000,114000,coach,Georgia,3200000,3314000,2014
Mark Richt,0.0,1000000,114000,coach,Georgia,3200000,3314000,2013
Mark Richt,0.0,1000000,114000,coach,Georgia,2811340,2925340,2012
Mark Richt,0.0,525000,128400,coach,Georgia,2811400,2939800,2011
Mark Richt,0.0,600000,126400,coach,Georgia,2811340,2937740,2010
Mark Richt,0.0,475000,2287236,coach,Georgia,809340,3096576,2009
Mark Richt,0.0,400000,1446600,coach,Georgia,578100,2024700,2007
Mark Richt,0.0,400000,1443000,coach,Georgia,270000,1713000,2006
David Shaw,0.0,0,0,coach,Stanford,5680441,5680441,2017
David Shaw,0.0,0,0,HC,Stanford,5680441,5680441,2017
David Shaw,0.0,0,0,coach,Stanford,4067219,4067219,2016
David Shaw,0.0,0,0,coach,Stanford,2224435,2224435,2015
David Shaw,0.0,0,0,coach,Stanford,2012666,2012666,2014
David Shaw,0.0,0,0,coach,Stanford,0,0,2013
David Shaw,0.0,0,0,coach,Stanford,0,0,2012
David Shaw,0.0,0,0,HC,Stanford,0,0,2012
David Shaw,0.0,0,0,coach,Stanford,0,0,2011
David Shaw,0.0,0,0,assistant,Stanford,0,0,2010
David Shaw,0.0,0,0,assistant,Stanford,0,0,2009
Mark Hudspeth,25000.0,155000,0,coach,Louisiana-Lafayette,1150000,1150000,2017
Mark Hudspeth,0.0,155000,0,coach,Louisiana-Lafayette,1100000,1100000,2016
Mark Hudspeth,45000.0,155000,3156,coach,Louisiana-Lafayette,1050000,1053156,2015
Mark Hudspeth,45000.0,155000,3156,HC,Louisiana-Lafayette,1050000,1053156,2015
Mark Hudspeth,0.0,155000,3156,coach,Louisiana-Lafayette,1000000,1003156,2014
Mark Hudspeth,0.0,155000,3156,HC,Louisiana-Lafayette,1000000,1003156,2014
Mark Hudspeth,0.0,105000,3000,coach,Louisiana-Lafayette,800000,803000,2013
Mark Hudspeth,0.0,105000,3000,coach,Louisiana-Lafayette,800000,803000,2012
Mark Hudspeth,0.0,105000,3000,HC,Louisiana-Lafayette,800000,803000,2012
Mark Hudspeth,0.0,65000,1000,coach,Louisiana-Lafayette,360000,361000,2011
Mark Hudspeth,0.0,65000,1000,HC,Louisiana-Lafayette,360000,361000,2011
Mark Hudspeth,0.0,0,0,AC,Mississippi State,200000,200000,2010
Mark Hudspeth,0.0,0,0,assistant,Mississippi State,200000,200000,2010
Mark Hudspeth,0.0,15883,0,assistant,Mississippi State,190000,190000,2009
Bret Bielema,125000.0,1000000,45000,coach,Arkansas,4200000,4245000,2017
Bret Bielema,100000.0,1000000,45000,coach,Arkansas,4100000,4145000,2016
Bret Bielema,100000.0,1000000,45000,HC,Arkansas,4100000,4145000,2016
Bret Bielema,100000.0,1000000,6500,coach,Arkansas,3954166,3960666,2015
Bret Bielema,0.0,700000,14000,coach,Arkansas,3200000,3214000,2014
Bret Bielema,0.0,700000,0,coach,Arkansas,5158863,5158863,2013
Bret Bielema,0.0,400000,40140,coach,Wisconsin,2600000,2640140,2012
Bret Bielema,0.0,400000,98186,coach,Wisconsin,2500000,2598186,2011
Bret Bielema,0.0,350000,81759,coach,Wisconsin,1700000,1781759,2010
Bret Bielema,0.0,350000,81759,HC,Wisconsin,1700000,1781759,2010
Bret Bielema,0.0,350000,1081506,coach,Wisconsin,400000,1481506,2009
Bret Bielema,0.0,350000,94638,coach,Wisconsin,1300000,1394638,2007
Bret Bielema,0.0,175000,11600,coach,Wisconsin,750000,761600,2006
Mike Jinks,25000.0,245000,0,coach,Bowling Green,428655,428655,2017
Mike Jinks,0.0,245000,0,coach,Bowling Green,410000,410000,2016
Mike Jinks,0.0,245000,0,HC,Bowling Green,410000,410000,2016
Mike Jinks,0.0,53750,3900,assistant,Texas Tech,215000,218900,2015
Mike Jinks,0.0,53750,2000,assistant,Texas Tech,215000,217000,2014
Mike Jinks,0.0,0,2000,assistant,Texas Tech,215000,217000,2013
Tom Herman,0.0,725000,0,coach,Texas,5486316,5486316,2017
Tom Herman,137500.0,447500,3500,coach,Houston,3000000,3003500,2016
Tom Herman,137500.0,447500,3500,HC,Houston,3000000,3003500,2016
Tom Herman,0.0,447500,0,coach,Houston,1450000,1450000,2015
Tom Herman,0.0,206250,0,assistant,Ohio State,550000,550000,2014
Tom Herman,0.0,206250,0,assistant,Ohio State,555000,555000,2013
Tom Herman,0.0,105000,0,assistant,Ohio State,426000,426000,2012
Tom Herman,0.0,29050,2000,assistant,Iowa State,350000,352000,2011
Tom Herman,0.0,45000,1000,assistant,Iowa State,300000,301000,2010
Tom Herman,0.0,37500,0,assistant,Iowa State,250000,250000,2009
Jay Norvell,0.0,210000,0,coach,Nevada,450000,450000,2017
Jay Norvell,0.0,115934,0,assistant,Arizona State,380000,380000,2016
Jay Norvell,0.0,180000,0,assistant,Texas,370000,370000,2015
Jay Norvell,0.0,77292,6600,assistant,Oklahoma,455000,461600,2014
Jay Norvell,0.0,85000,6000,assistant,Oklahoma,400000,406000,2013
Jay Norvell,0.0,65000,10000,assistant,Oklahoma,350000,360000,2012
Jay Norvell,0.0,63333,5000,AC,Oklahoma,330000,335000,2011
Jay Norvell,0.0,63333,5000,assistant,Oklahoma,330000,335000,2011
Jay Norvell,0.0,50600,11000,assistant,Oklahoma,255000,266000,2010
Jay Norvell,0.0,50600,61900,AC,Oklahoma,180000,241900,2009
Jay Norvell,0.0,50600,61900,assistant,Oklahoma,180000,241900,2009
Kliff Kingsbury,90000.0,1500000,0,coach,Texas Tech,3503975,3503975,2017
Kliff Kingsbury,50000.0,1500000,0,coach,Texas Tech,3306575,3306575,2016
Kliff Kingsbury,70000.0,1500000,39500,coach,Texas Tech,3108000,3147500,2015
Kliff Kingsbury,0.0,1500000,300,coach,Texas Tech,2605000,2605300,2014
Kliff Kingsbury,0.0,600000,300,coach,Texas Tech,1855000,1855300,2013
Kliff Kingsbury,0.0,80000,0,assistant,Texas A&M,406000,406000,2012
Kliff Kingsbury,0.0,29000,0,assistant,Houston,145000,145000,2011
Kliff Kingsbury,0.0,24000,0,AC,Houston,120000,120000,2010
Kliff Kingsbury,0.0,24000,0,assistant,Houston,120000,120000,2010
Mike MacIntyre,772500.0,2150000,0,coach,Colorado,2803500,2803500,2017
Mike MacIntyre,300000.0,1500000,400,coach,Colorado,2011050,2011450,2016
Mike MacIntyre,292000.0,1500000,575,coach,Colorado,2009778,2010353,2015
Mike MacIntyre,0.0,1500000,1650,coach,Colorado,2008500,2010150,2014
Mike MacIntyre,0.0,1500000,0,coach,Colorado,2403500,2403500,2013
Mike MacIntyre,0.0,300835,10000,coach,San Jose State,401820,411820,2012
Mike MacIntyre,0.0,300835,10000,HC,San Jose State,401820,411820,2012
Mike MacIntyre,0.0,300835,10000,coach,San Jose State,401820,411820,2011
Mike MacIntyre,0.0,300835,2000,coach,San Jose State,401820,403820,2010
Mike MacIntyre,0.0,0,0,assistant,Duke,0,0,2009
Joey Jones,42704.0,183869,30000,coach,South Alabama,535260,565260,2017
Joey Jones,5000.0,211025,35000,coach,South Alabama,525000,560000,2016
Joey Jones,31438.0,211025,35500,coach,South Alabama,525000,560500,2015
Joey Jones,0.0,171000,36000,coach,South Alabama,435000,471000,2014
Joey Jones,0.0,38871,26000,coach,South Alabama,358450,384450,2013
Joey Jones,0.0,38871,26000,HC,South Alabama,358450,384450,2013
Joey Jones,0.0,50625,26000,coach,South Alabama,345125,371125,2012
Randy Edsall,0.0,650000,0,coach,Connecticut,1000000,1000000,2017
Randy Edsall,200000.0,950000,200,coach,Maryland,2110648,2110848,2015
Randy Edsall,0.0,950000,200,coach,Maryland,2033680,2033880,2014
Randy Edsall,0.0,950000,200,HC,Maryland,2033680,2033880,2014
Randy Edsall,0.0,950000,4000,coach,Maryland,2021440,2025440,2013
Randy Edsall,0.0,950000,4000,coach,Maryland,1600000,1604000,2012
Randy Edsall,0.0,875000,0,coach,Maryland,2013440,2013440,2011
Randy Edsall,0.0,114583,0,coach,Connecticut,1550000,1550000,2010
Randy Edsall,0.0,114583,0,HC,Connecticut,1550000,1550000,2010
Randy Edsall,0.0,113542,1125000,coach,Connecticut,325000,1450000,2009
Randy Edsall,0.0,68751,645000,coach,Connecticut,275000,920000,2007
Randy Edsall,0.0,0,595000,coach,Connecticut,250000,845000,2006
Randy Edsall,0.0,0,595000,HC,Connecticut,250000,845000,2006
Kevin Sumlin,100000.0,1050000,0,coach,Texas A&M,5000000,5000000,2017
Kevin Sumlin,100000.0,1050000,0,HC,Texas A&M,5000000,5000000,2017
Kevin Sumlin,50000.0,1350000,0,coach,Texas A&M,5000000,5000000,2016
Kevin Sumlin,50000.0,1350000,0,coach,Texas A&M,5000000,5000000,2015
Kevin Sumlin,0.0,750000,6000,coach,Texas A&M,5000000,5006000,2014
Kevin Sumlin,0.0,750000,6000,HC,Texas A&M,5000000,5006000,2014
Kevin Sumlin,0.0,750000,300,coach,Texas A&M,3100000,3100300,2013
Kevin Sumlin,0.0,625000,300,coach,Texas A&M,2436000,2436300,2012
Kevin Sumlin,0.0,500000,0,coach,Houston,1200000,1200000,2011
Kevin Sumlin,0.0,500000,0,HC,Houston,1200000,1200000,2011
Kevin Sumlin,0.0,500000,0,coach,Houston,1000000,1000000,2010
Kevin Sumlin,0.0,325000,400000,coach,Houston,350000,750000,2009
Scott Satterfield,155000.0,270000,0,coach,Appalachian State,675000,675000,2017
Scott Satterfield,155000.0,270000,0,HC,Appalachian State,675000,675000,2017
Scott Satterfield,30000.0,290000,0,coach,Appalachian State,525000,525000,2016
Scott Satterfield,27500.0,165000,0,coach,Appalachian State,375000,375000,2015
Scott Satterfield,0.0,25000,0,coach,Appalachian State,225000,225000,2014
Scott Satterfield,0.0,10000,0,assistant,Florida International,133100,133100,2011
Scott Satterfield,0.0,10000,0,assistant,Florida International,146969,146969,2010
Scott Satterfield,0.0,1500,0,assistant,Toledo,120000,120000,2009
Rich Rodriguez,25000.0,2025000,400000,coach,Arizona,5631563,6031563,2017
Rich Rodriguez,50000.0,2025000,360000,coach,Arizona,2500000,2860000,2016
Rich Rodriguez,650000.0,2025000,360000,coach,Arizona,2878844,3238844,2015
Rich Rodriguez,650000.0,2025000,360000,HC,Arizona,2878844,3238844,2015
Rich Rodriguez,0.0,2125000,400000,coach,Arizona,2898500,3298500,2014
Rich Rodriguez,0.0,610000,300000,coach,Arizona,1850000,2150000,2013
Rich Rodriguez,0.0,525000,0,coach,Arizona,1500000,1500000,2012
Rich Rodriguez,0.0,525000,0,HC,Arizona,1500000,1500000,2012
Rich Rodriguez,0.0,300000,10100,coach,Michigan,2515180,2525280,2010
Rich Rodriguez,0.0,300000,1662000,coach,Michigan,859000,2521000,2009
Rich Rodriguez,0.0,385000,600000,coach,West Virginia,1203000,1803000,2007
Rich Rodriguez,0.0,415000,850000,coach,West Virginia,250000,1100000,2006
Willie Taggart,0.0,1825000,0,coach,Oregon,2900000,2900000,2017
Willie Taggart,25000.0,900000,4000,coach,South Florida,1700000,1704000,2016
Willie Taggart,0.0,650000,2500,coach,South Florida,1150000,1152500,2015
Willie Taggart,0.0,650000,32000,coach,South Florida,1150000,1182000,2014
Willie Taggart,0.0,650000,32000,HC,South Florida,1150000,1182000,2014
Willie Taggart,0.0,650000,0,coach,South Florida,1807745,1807745,2013
Willie Taggart,0.0,168750,4800,coach,Western Kentucky,475000,479800,2012
Willie Taggart,0.0,168750,4800,HC,Western Kentucky,475000,479800,2012
Willie Taggart,0.0,144750,0,coach,Western Kentucky,225000,225000,2011
Willie Taggart,0.0,144750,0,HC,Western Kentucky,225000,225000,2011
Willie Taggart,0.0,144750,0,coach,Western Kentucky,225000,225000,2010
Willie Taggart,0.0,0,0,assistant,Stanford,0,0,2009
Terry Bowden,5000.0,225000,1500,coach,Akron,411000,412500,2017
Terry Bowden,30000.0,225000,1500,coach,Akron,411000,412500,2016
Terry Bowden,10000.0,255000,1500,coach,Akron,406000,407500,2015
Terry Bowden,0.0,255000,0,coach,Akron,406000,406000,2014
Terry Bowden,0.0,205000,0,coach,Akron,400000,400000,2013
Terry Bowden,0.0,205000,0,HC,Akron,400000,400000,2013
Terry Bowden,0.0,90000,0,coach,Akron,375000,375000,2012
Tim Lester,0.0,322000,0,coach,Western Michigan,800000,800000,2017
Tim Lester,0.0,165000,0,assistant,Purdue,205000,205000,2016
Tim Lester,0.0,0,0,assistant,Syracuse,0,0,2015
Tim Lester,0.0,0,0,AC,Syracuse,0,0,2014
Tim Lester,0.0,0,0,assistant,Syracuse,0,0,2014
Tim Lester,0.0,0,0,assistant,Syracuse,0,0,2013
Mike Sanford Jr.,0.0,400000,0,coach,Western Kentucky,800000,800000,2017
Mike Sanford Jr.,0.0,0,0,AC,Notre Dame,0,0,2016
Mike Sanford Jr.,0.0,0,0,assistant,Notre Dame,0,0,2016
Mike Sanford Jr.,0.0,0,0,assistant,Notre Dame,0,0,2015
Mike Sanford Jr.,0.0,19751,0,assistant,Boise State,305012,305012,2014
Mike Sanford Jr.,0.0,0,0,assistant,Stanford,0,0,2013
Mike Sanford Jr.,0.0,0,0,assistant,Stanford,0,0,2012
Mike Sanford Jr.,0.0,0,0,assistant,Stanford,0,0,2011
Mike Sanford Jr.,0.0,0,0,assistant,Western Kentucky,70008,70008,2010
Matt Viator,0.0,50000,0,coach,Louisiana-Monroe,390000,390000,2017
Matt Viator,0.0,50000,0,coach,Louisiana-Monroe,390000,390000,2016
Bob Davie,20000.0,490000,1250,coach,New Mexico,822690,823940,2017
Bob Davie,20000.0,490000,1250,coach,New Mexico,822690,823940,2016
Bob Davie,0.0,490000,1250,coach,New Mexico,772690,773940,2015
Bob Davie,0.0,480000,11000,coach,New Mexico,772690,783690,2014
Bob Davie,0.0,330000,0,coach,New Mexico,763600,763600,2013
Bob Davie,0.0,330000,0,HC,New Mexico,763600,763600,2013
Bob Davie,0.0,350000,0,coach,New Mexico,760000,760000,2012
Tony Sanchez,30000.0,260000,0,coach,UNLV,600000,600000,2017
Tony Sanchez,15000.0,325000,0,coach,UNLV,510000,510000,2016
Tony Sanchez,0.0,175000,0,coach,UNLV,560000,560000,2015
Scott Frost,45000.0,250000,0,coach,UCF,2000000,2000000,2017
Scott Frost,0.0,250000,0,coach,UCF,1700000,1700000,2016
Scott Frost,0.0,375000,0,assistant,Oregon,755000,755000,2015
Scott Frost,0.0,258333,0,assistant,Oregon,400000,400000,2014
Scott Frost,0.0,222528,0,assistant,Oregon,367584,367584,2013
Scott Frost,0.0,191666,0,assistant,Oregon,202500,202500,2012
Scott Frost,0.0,200000,5000,assistant,Oregon,195000,200000,2011
Scott Frost,0.0,285333,0,assistant,Oregon,145000,145000,2010
Scott Frost,0.0,0,5000,AC,Oregon,130000,135000,2009
Scott Frost,0.0,0,5000,assistant,Oregon,130000,135000,2009
Troy Calhoun,0.0,0,0,coach,Air Force,0,0,2017
Troy Calhoun,85000.0,0,0,coach,Air Force,885000,885000,2016
Troy Calhoun,123750.0,255000,26500,coach,Air Force,892500,919000,2015
Troy Calhoun,0.0,247500,26500,coach,Air Force,866250,892750,2014
Troy Calhoun,0.0,247500,21100,coach,Air Force,882000,903100,2013
Troy Calhoun,0.0,247000,0,coach,Air Force,882000,882000,2012
Troy Calhoun,0.0,247500,22845,coach,Air Force,866250,889095,2011
Troy Calhoun,0.0,580000,18500,coach,Air Force,725000,743500,2010
Troy Calhoun,0.0,580000,18500,HC,Air Force,725000,743500,2010
Troy Calhoun,0.0,217500,16500,coach,Air Force,760000,776500,2009
Troy Calhoun,0.0,125000,21500,coach,Air Force,550000,571500,2007
Clay Helton,0.0,0,0,coach,USC,0,0,2017
Clay Helton,0.0,0,0,coach,USC,0,0,2016
Clay Helton,0.0,0,0,AC,USC,0,0,2015
Clay Helton,0.0,0,0,assistant,USC,0,0,2015
Clay Helton,0.0,0,0,assistant,USC,0,0,2014
Clay Helton,0.0,0,0,assistant,USC,0,0,2013
Clay Helton,0.0,0,0,AC,USC,0,0,2012
Clay Helton,0.0,0,0,assistant,USC,0,0,2012
Clay Helton,0.0,0,0,assistant,USC,0,0,2011
Clay Helton,0.0,0,0,assistant,USC,0,0,2010
Clay Helton,0.0,14167,0,assistant,Memphis,170000,170000,2009
Will Muschamp,125000.0,1075000,0,coach,South Carolina,3100000,3100000,2017
Will Muschamp,0.0,1075000,2500,coach,South Carolina,3000000,3002500,2016
Will Muschamp,0.0,130000,0,assistant,Auburn,1600000,1600000,2015
Will Muschamp,0.0,454000,6500,coach,Florida,2724500,2731000,2014
Will Muschamp,0.0,454000,10000,coach,Florida,2724500,2734500,2013
Will Muschamp,0.0,450000,0,coach,Florida,2474500,2474500,2012
Will Muschamp,0.0,450000,0,HC,Florida,2474500,2474500,2012
Will Muschamp,0.0,450000,0,coach,Florida,3221000,3221000,2011
Will Muschamp,0.0,95000,7000,assistant,Texas,900000,907000,2010
Will Muschamp,0.0,93150,57500,assistant,Texas,850000,907500,2009
Shawn Elliott,0.0,220000,0,coach,Georgia State,565000,565000,2017
Shawn Elliott,0.0,115000,2400,assistant,South Carolina,500000,502400,2016
Shawn Elliott,0.0,35555,2400,assistant,South Carolina,400000,402400,2015
Shawn Elliott,0.0,35555,5400,assistant,South Carolina,430000,435400,2014
Shawn Elliott,0.0,35555,34650,assistant,South Carolina,325000,359650,2013
Shawn Elliott,0.0,35555,4600,assistant,South Carolina,300000,304600,2012
Shawn Elliott,0.0,0,3680,assistant,South Carolina,185000,188680,2011
Shawn Elliott,0.0,5555,8150,assistant,South Carolina,150000,158150,2010
Rick Stockstill,65142.0,126142,0,coach,Middle Tennessee,801504,801504,2017
Rick Stockstill,65142.0,126142,2500,coach,Middle Tennessee,801504,804004,2016
Rick Stockstill,5000.0,126142,10500,coach,Middle Tennessee,801504,812004,2015
Rick Stockstill,0.0,126142,1625,coach,Middle Tennessee,801504,803129,2014
Rick Stockstill,0.0,157809,2500,coach,Middle Tennessee,701504,704004,2013
Rick Stockstill,0.0,157809,2500,HC,Middle Tennessee,701504,704004,2013
Rick Stockstill,0.0,149475,625,coach,Middle Tennessee,601504,602129,2012
Rick Stockstill,0.0,148415,625,coach,Middle Tennessee,588780,589405,2011
Rick Stockstill,0.0,111000,2625,coach,Middle Tennessee,488955,491580,2010
Rick Stockstill,0.0,112180,86500,coach,Middle Tennessee,195155,281655,2009
Rick Stockstill,0.0,75000,75000,coach,Middle Tennessee,207955,282955,2007
Rick Stockstill,0.0,75000,75000,HC,Middle Tennessee,207955,282955,2007
Rick Stockstill,0.0,130583,75000,coach,Middle Tennessee,179800,254800,2006
Brian Kelly,0.0,0,0,coach,Notre Dame,1645867,1645867,2017
Brian Kelly,0.0,0,0,coach,Notre Dame,1624730,1624730,2016
Brian Kelly,0.0,0,0,coach,Notre Dame,1187272,1187272,2015
Brian Kelly,0.0,0,0,coach,Notre Dame,1457284,1457284,2014
Brian Kelly,0.0,0,0,coach,Notre Dame,1088179,1088179,2013
Brian Kelly,0.0,0,0,coach,Notre Dame,2424301,2424301,2012
Brian Kelly,0.0,0,0,HC,Notre Dame,2424301,2424301,2012
Brian Kelly,0.0,0,0,coach,Notre Dame,0,0,2011
Brian Kelly,0.0,0,0,coach,Notre Dame,0,0,2010
Brian Kelly,0.0,400000,1047500,coach,Cincinnati,315000,1362500,2009
Brian Kelly,0.0,380000,450000,coach,Cincinnati,385000,835000,2007
Brian Kelly,0.0,14500,25500,coach,Central Michigan,159397,184897,2006
Brian Kelly,0.0,14500,25500,HC,Central Michigan,159397,184897,2006
Jeff Monken,0.0,0,0,coach,Army,0,0,2017
Jeff Monken,0.0,256000,0,coach,Army,932521,932521,2016
Jeff Monken,0.0,256000,0,coach,Army,883000,883000,2015
Jeff Monken,0.0,256000,0,HC,Army,883000,883000,2015
Jeff Monken,0.0,256000,0,coach,Army,834667,834667,2014
Jeff Monken,0.0,256000,0,HC,Army,834667,834667,2014
Jeff Monken,0.0,0,0,assistant,Georgia Tech,178500,178500,2009
Chad Morris,0.0,0,0,coach,Southern Methodist,2095793,2095793,2017
Chad Morris,0.0,0,0,coach,Southern Methodist,0,0,2016
Chad Morris,0.0,0,0,HC,Southern Methodist,0,0,2016
Chad Morris,0.0,0,0,coach,Southern Methodist,0,0,2015
Chad Morris,0.0,120417,1250,assistant,Clemson,1300000,1301250,2014
Chad Morris,0.0,120417,9650,assistant,Clemson,1300000,1309650,2013
Chad Morris,0.0,120417,6500,AC,Clemson,1300000,1306500,2012
Chad Morris,0.0,120417,6500,assistant,Clemson,1300000,1306500,2012
Chad Morris,0.0,120417,0,assistant,Clemson,450000,450000,2011
Chad Morris,0.0,0,0,AC,Tulsa,0,0,2010
Chad Morris,0.0,0,0,assistant,Tulsa,0,0,2010
Mike Gundy,62500.0,900000,0,coach,Oklahoma State,4200000,4200000,2017
Mike Gundy,100000.0,550000,0,coach,Oklahoma State,3775000,3775000,2016
Mike Gundy,100000.0,550000,0,HC,Oklahoma State,3775000,3775000,2016
Mike Gundy,62500.0,550000,0,coach,Oklahoma State,3650000,3650000,2015
Mike Gundy,0.0,550000,0,coach,Oklahoma State,3500000,3500000,2014
Mike Gundy,0.0,550000,0,HC,Oklahoma State,3500000,3500000,2014
Mike Gundy,0.0,550000,0,coach,Oklahoma State,3450000,3450000,2013
Mike Gundy,0.0,550000,0,coach,Oklahoma State,3275000,3275000,2012
Mike Gundy,0.0,500000,0,coach,Oklahoma State,2100000,2100000,2011
Mike Gundy,0.0,500000,0,coach,Oklahoma State,1925000,1925000,2010
Mike Gundy,0.0,500000,1425000,coach,Oklahoma State,375000,1800000,2009
Mike Gundy,0.0,684000,675000,coach,Oklahoma State,275000,950000,2007
Mike Gundy,0.0,684000,550000,coach,Oklahoma State,250000,800000,2006
Neal Brown,80000.0,490000,0,coach,Troy,800000,800000,2017
Neal Brown,80000.0,490000,0,HC,Troy,800000,800000,2017
Neal Brown,0.0,490000,0,coach,Troy,660000,660000,2016
Neal Brown,0.0,475000,0,coach,Troy,660000,660000,2015
Neal Brown,0.0,91667,2400,assistant,Kentucky,550000,552400,2014
Neal Brown,0.0,91667,0,assistant,Kentucky,550000,550000,2013
Neal Brown,0.0,0,3500,assistant,Texas Tech,400000,403500,2012
Neal Brown,0.0,0,5400,assistant,Texas Tech,400000,405400,2011
Neal Brown,0.0,0,5400,assistant,Texas Tech,350000,355400,2010
Neal Brown,0.0,6000,2500,assistant,Troy,91670,94170,2009
Steve Addazio,0.0,0,0,coach,Boston College,2448949,2448949,2017
Steve Addazio,0.0,0,0,coach,Boston College,2333628,2333628,2016
Steve Addazio,0.0,0,0,HC,Boston College,2333628,2333628,2016
Steve Addazio,0.0,0,0,coach,Boston College,2585655,2585655,2015
Steve Addazio,0.0,0,0,coach,Boston College,0,0,2014
Steve Addazio,0.0,0,0,HC,Boston College,0,0,2014
Steve Addazio,0.0,0,0,coach,Boston College,0,0,2013
Steve Addazio,0.0,0,0,coach,Temple,0,0,2012
Steve Addazio,0.0,0,0,HC,Temple,0,0,2012
Steve Addazio,0.0,0,0,coach,Temple,0,0,2011
Steve Addazio,0.0,150000,0,assistant,Florida,385000,385000,2010
Steve Addazio,0.0,0,10000,AC,Florida,200000,210000,2009
Steve Addazio,0.0,0,10000,assistant,Florida,200000,210000,2009
Kalani Sitake,0.0,0,0,coach,Brigham Young,0,0,2017
Kalani Sitake,0.0,0,0,coach,Brigham Young,0,0,2016
Kalani Sitake,0.0,166111,0,assistant,Oregon State,730008,730008,2015
Kalani Sitake,0.0,41667,0,assistant,Utah,500000,500000,2014
Kalani Sitake,0.0,41667,0,assistant,Utah,500000,500000,2013
Kalani Sitake,0.0,41667,0,assistant,Utah,500000,500000,2012
Kalani Sitake,0.0,13333,600,AC,Utah,160000,160600,2009
Kalani Sitake,0.0,13333,600,assistant,Utah,160000,160600,2009
Bronco Mendenhall,0.0,2165000,0,coach,Virginia,3400000,3400000,2017
Bronco Mendenhall,0.0,2445000,0,coach,Virginia,3275000,3275000,2016
Bronco Mendenhall,0.0,0,0,coach,Brigham Young,0,0,2015
Bronco Mendenhall,0.0,0,0,coach,Brigham Young,0,0,2014
Bronco Mendenhall,0.0,0,0,coach,Brigham Young,0,0,2013
Bronco Mendenhall,0.0,0,0,coach,Brigham Young,0,0,2012
Bronco Mendenhall,0.0,0,0,coach,Brigham Young,0,0,2011
Bronco Mendenhall,0.0,0,0,coach,Brigham Young,0,0,2010
Bronco Mendenhall,0.0,0,0,HC,Brigham Young,0,0,2010
Bronco Mendenhall,0.0,0,0,coach,Brigham Young,0,0,2009
Bronco Mendenhall,0.0,0,0,HC,Brigham Young,0,0,2009
Bronco Mendenhall,0.0,0,0,coach,Brigham Young,0,0,2007
Bronco Mendenhall,0.0,0,0,coach,Brigham Young,0,0,2006
Craig Bohl,213750.0,450000,0,coach,Wyoming,1412000,1412000,2017
Craig Bohl,105000.0,330000,0,coach,Wyoming,909000,909000,2016
Craig Bohl,105000.0,330000,0,HC,Wyoming,909000,909000,2016
Craig Bohl,120000.0,330000,0,coach,Wyoming,882000,882000,2015
Craig Bohl,0.0,330000,0,coach,Wyoming,832000,832000,2014
Bobby Petrino,989584.0,1468750,0,coach,Louisville,3930434,3930434,2017
Bobby Petrino,989584.0,1468750,0,HC,Louisville,3930434,3930434,2017
Bobby Petrino,794667.0,1464583,30000,coach,Louisville,3880434,3910434,2016
Bobby Petrino,782667.0,1341667,3500,coach,Louisville,3000000,3003500,2015
Bobby Petrino,782667.0,1341667,3500,HC,Louisville,3000000,3003500,2015
Bobby Petrino,0.0,1266667,0,coach,Louisville,3000000,3000000,2014
Bobby Petrino,0.0,355000,0,coach,Western Kentucky,855600,855600,2013
Bobby Petrino,0.0,650000,3000,coach,Arkansas,3635000,3638000,2011
Bobby Petrino,0.0,475000,13000,coach,Arkansas,2700000,2713000,2010
Bobby Petrino,0.0,550000,958000,coach,Arkansas,1900000,2858000,2009
Bobby Petrino,0.0,766667,941000,coach,Louisville,810000,1751000,2006
Bobby Petrino,0.0,766667,941000,HC,Louisville,810000,1751000,2006
Lovie Smith,75000.0,1000000,0,coach,Illinois,3000000,3000000,2017
Lovie Smith,0.0,1000000,0,coach,Illinois,1809179,1809179,2016
David Beaty,25000.0,1750000,0,coach,Kansas,1601109,1601109,2017
David Beaty,0.0,925000,0,coach,Kansas,801109,801109,2016
David Beaty,0.0,925000,0,coach,Kansas,801169,801169,2015
David Beaty,0.0,48400,1500,assistant,Texas A&M,358000,359500,2014
David Beaty,0.0,48400,0,assistant,Texas A&M,359500,359500,2013
David Beaty,0.0,43000,0,assistant,Texas A&M,220000,220000,2012
David Beaty,0.0,41667,0,assistant,Kansas,250000,250000,2011
David Beaty,0.0,0,0,assistant,Rice,0,0,2010
David Beaty,0.0,0,2800,assistant,Kansas,163500,166300,2009
Ken Niumatalolo,0.0,0,0,coach,Navy,2000000,2000000,2017
Ken Niumatalolo,0.0,0,0,HC,Navy,2000000,2000000,2017
Ken Niumatalolo,0.0,0,0,coach,Navy,2000000,2000000,2016
Ken Niumatalolo,0.0,0,0,coach,Navy,1637803,1637803,2015
Ken Niumatalolo,0.0,0,0,coach,Navy,1574810,1574810,2014
Ken Niumatalolo,0.0,0,0,coach,Navy,1514240,1514240,2013
Ken Niumatalolo,0.0,0,0,coach,Navy,1605370,1605370,2012
Ken Niumatalolo,0.0,0,0,coach,Navy,1538190,1538190,2011
Ken Niumatalolo,0.0,0,0,HC,Navy,1538190,1538190,2011
Ken Niumatalolo,0.0,0,0,coach,Navy,1852868,1852868,2010
Ken Niumatalolo,0.0,0,0,coach,Navy,468464,468464,2009
Justin Fuente,125000.0,435000,0,coach,Virginia Tech,3250000,3250000,2017
Justin Fuente,0.0,400000,0,coach,Virginia Tech,3200000,3200000,2016
Justin Fuente,235000.0,725000,0,coach,Memphis,1400000,1400000,2015
Justin Fuente,0.0,725000,0,coach,Memphis,1006779,1006779,2014
Justin Fuente,0.0,625000,0,coach,Memphis,956779,956779,2013
Justin Fuente,0.0,625000,0,coach,Memphis,903285,903285,2012
Justin Fuente,0.0,0,0,assistant,TCU,0,0,2011
Justin Fuente,0.0,0,0,assistant,TCU,0,0,2010
Justin Fuente,0.0,0,0,AC,TCU,0,0,2009
Justin Fuente,0.0,0,0,assistant,TCU,0,0,2009
Jimbo Fisher,200000.0,1475000,0,coach,Florida State,5700000,5700000,2017
Jimbo Fisher,100000.0,1475000,0,coach,Florida State,5250000,5250000,2016
Jimbo Fisher,500000.0,1475000,0,coach,Florida State,5150000,5150000,2015
Jimbo Fisher,0.0,1275000,0,coach,Florida State,3591667,3591667,2014
Jimbo Fisher,0.0,675000,0,coach,Florida State,2750000,2750000,2013
Jimbo Fisher,0.0,675000,0,coach,Florida State,2750000,2750000,2012
Jimbo Fisher,0.0,725000,0,coach,Florida State,2750000,2750000,2011
Jimbo Fisher,0.0,675000,3500,coach,Florida State,1800000,1803500,2010
Jimbo Fisher,0.0,26875,414000,assistant,Florida State,215000,629000,2009
Mike Norvell,125000.0,570000,0,coach,Memphis,1860000,1860000,2017
Mike Norvell,125000.0,570000,0,HC,Memphis,1860000,1860000,2017
Mike Norvell,0.0,570000,0,coach,Memphis,1800000,1800000,2016
Mike Norvell,0.0,570000,0,HC,Memphis,1800000,1800000,2016
Mike Norvell,0.0,490000,85,assistant,Arizona State,950000,950085,2015
Mike Norvell,0.0,490000,1560,assistant,Arizona State,900000,901560,2014
Mike Norvell,0.0,123334,2420,assistant,Arizona State,500000,502420,2013
Mike Norvell,0.0,0,0,assistant,Arizona State,320000,320000,2012
Mike Norvell,0.0,0,0,AC,Pittsburgh,0,0,2011
Mike Norvell,0.0,0,0,assistant,Pittsburgh,0,0,2011
Mike Norvell,0.0,0,0,AC,Tulsa,0,0,2010
Mike Norvell,0.0,0,0,assistant,Tulsa,0,0,2010
Mike Norvell,0.0,0,0,assistant,Tulsa,0,0,2009
Bill Clark,0.0,685000,0,coach,UAB,630000,630000,2017
Bill Clark,0.0,685000,0,HC,UAB,630000,630000,2017
Bill Clark,0.0,430000,0,coach,UAB,500000,500000,2014
Bill Clark,0.0,16810,35821,assistant,South Alabama,140480,176301,2012
Matt Rhule,0.0,0,0,coach,Baylor,0,0,2017
Matt Rhule,0.0,0,0,coach,Temple,1041739,1041739,2016
Matt Rhule,0.0,0,0,coach,Temple,648633,648633,2015
Matt Rhule,0.0,0,0,HC,Temple,648633,648633,2015
Matt Rhule,0.0,0,0,coach,Temple,0,0,2014
Matt Rhule,0.0,0,0,coach,Temple,0,0,2013
Matt Rhule,0.0,0,0,assistant,Temple,0,0,2011
Matt Rhule,0.0,0,0,assistant,Temple,0,0,2010
Matt Rhule,0.0,0,0,assistant,Temple,0,0,2009
Matt Wells,10000.0,730000,0,coach,Utah State,1050000,1050000,2017
Matt Wells,60000.0,730000,0,coach,Utah State,800000,800000,2016
Matt Wells,60000.0,730000,0,HC,Utah State,800000,800000,2016
Matt Wells,65000.0,770000,2900,coach,Utah State,750000,752900,2015
Matt Wells,0.0,765000,1434,coach,Utah State,575000,576434,2014
Matt Wells,0.0,765000,1434,HC,Utah State,575000,576434,2014
Matt Wells,0.0,735000,2500,coach,Utah State,500000,502500,2013
Matt Wells,0.0,0,2000,AC,Utah State,138000,140000,2012
Matt Wells,0.0,0,2000,assistant,Utah State,138000,140000,2012
Matt Wells,0.0,0,0,assistant,Utah State,100000,100000,2011
Matt Wells,0.0,0,1000,AC,New Mexico,75000,76000,2010
Matt Wells,0.0,0,1000,assistant,New Mexico,75000,76000,2010
Matt Wells,0.0,11667,0,assistant,Louisville,140000,140000,2009
Todd Graham,445000.0,3906000,8779,coach,Arizona State,3200000,3208779,2017
Todd Graham,445000.0,3906000,8779,HC,Arizona State,3200000,3208779,2017
Todd Graham,375000.0,3823000,3438,coach,Arizona State,3100000,3103438,2016
Todd Graham,375000.0,3823000,3438,HC,Arizona State,3100000,3103438,2016
Todd Graham,627000.0,3740000,2960,coach,Arizona State,3000000,3002960,2015
Todd Graham,627000.0,3740000,2960,HC,Arizona State,3000000,3002960,2015
Todd Graham,0.0,3491000,2960,coach,Arizona State,2700000,2702960,2014
Todd Graham,0.0,3491000,2960,HC,Arizona State,2700000,2702960,2014
Todd Graham,0.0,3159000,3020,coach,Arizona State,2300000,2303020,2013
Todd Graham,0.0,2050000,0,coach,Arizona State,3000000,3000000,2012
Todd Graham,0.0,0,0,coach,Pittsburgh,0,0,2011
Todd Graham,0.0,0,0,HC,Pittsburgh,0,0,2011
Todd Graham,0.0,0,0,coach,Tulsa,804253,804253,2010
Todd Graham,0.0,0,0,coach,Tulsa,769264,769264,2009
Todd Graham,0.0,0,0,coach,Tulsa,0,0,2007
Todd Graham,0.0,0,0,coach,Rice,0,0,2006
Pat Narduzzi,0.0,0,0,coach,Pittsburgh,1827735,1827735,2017
Pat Narduzzi,0.0,0,0,HC,Pittsburgh,1827735,1827735,2017
Pat Narduzzi,0.0,0,0,coach,Pittsburgh,0,0,2016
Pat Narduzzi,0.0,0,0,coach,Pittsburgh,0,0,2015
Pat Narduzzi,0.0,0,2000,assistant,Michigan State,905033,907033,2014
Pat Narduzzi,0.0,0,1700,assistant,Michigan State,557208,558908,2013
Pat Narduzzi,0.0,0,1700,assistant,Michigan State,500000,501700,2012
Pat Narduzzi,0.0,0,0,assistant,Michigan State,235000,235000,2011
Pat Narduzzi,0.0,0,2250,assistant,Michigan State,233000,235250,2010
Pat Narduzzi,0.0,38250,0,assistant,Michigan State,229500,229500,2009
Larry Fedora,50000.0,900000,0,coach,North Carolina,2290000,2290000,2017
Larry Fedora,50000.0,900000,0,HC,North Carolina,2290000,2290000,2017
Larry Fedora,58500.0,348444,0,coach,North Carolina,1986265,1986265,2016
Larry Fedora,29250.0,346250,0,coach,North Carolina,1931000,1931000,2015
Larry Fedora,0.0,345835,0,coach,North Carolina,1830000,1830000,2014
Larry Fedora,0.0,345835,0,coach,North Carolina,1730000,1730000,2013
Larry Fedora,0.0,29167,0,coach,North Carolina,2448605,2448605,2012
Larry Fedora,0.0,387500,19500,coach,Southern Miss,685000,704500,2011
Larry Fedora,0.0,165000,19500,coach,Southern Miss,685000,704500,2010
Larry Fedora,0.0,160000,394500,coach,Southern Miss,341602,736102,2009
Doug Martin,0.0,135000,0,coach,New Mexico State,376044,376044,2017
Doug Martin,0.0,135000,0,coach,New Mexico State,376044,376044,2016
Doug Martin,0.0,135000,1000,coach,New Mexico State,376044,377044,2015
Doug Martin,0.0,185000,1000,coach,New Mexico State,376044,377044,2014
Doug Martin,0.0,185000,0,coach,New Mexico State,375000,375000,2013
Doug Martin,0.0,0,0,AC,Boston College,0,0,2012
Doug Martin,0.0,0,0,assistant,Boston College,0,0,2012
Doug Martin,0.0,0,0,assistant,New Mexico State,90000,90000,2011
Doug Martin,0.0,91500,0,coach,Kent State,190000,190000,2010
Doug Martin,0.0,91500,0,HC,Kent State,190000,190000,2010
Doug Martin,0.0,91500,0,coach,Kent State,190000,190000,2009
Doug Martin,0.0,84000,0,coach,Kent State,170000,170000,2007
Doug Martin,0.0,42000,0,coach,Kent State,150200,150200,2006
Geoff Collins,0.0,0,0,coach,Temple,0,0,2017
Geoff Collins,0.0,236000,0,assistant,Florida,1051500,1051500,2016
Geoff Collins,0.0,236000,0,assistant,Florida,701500,701500,2015
Geoff Collins,0.0,47917,0,assistant,Mississippi State,575000,575000,2014
Geoff Collins,0.0,0,0,assistant,Mississippi State,291700,291700,2013
Geoff Collins,0.0,0,3500,assistant,Mississippi State,284200,287700,2012
Geoff Collins,0.0,0,0,AC,Mississippi State,280000,280000,2011
Geoff Collins,0.0,0,0,assistant,Mississippi State,280000,280000,2011
Geoff Collins,0.0,10000,0,assistant,Florida International,146969,146969,2010
Geoff Collins,0.0,10628,1500,AC,UCF,127531,129031,2009
Geoff Collins,0.0,10628,1500,assistant,UCF,127531,129031,2009
Chuck Martin,51643.0,548162,0,coach,Miami (OH),522300,522300,2017
Chuck Martin,6750.0,498081,0,coach,Miami (OH),472300,472300,2016
Chuck Martin,20250.0,482493,0,coach,Miami (OH),450000,450000,2015
Chuck Martin,0.0,462243,0,coach,Miami (OH),450000,450000,2014
Chuck Martin,0.0,462243,0,HC,Miami (OH),450000,450000,2014
Chuck Martin,0.0,0,0,assistant,Notre Dame,0,0,2013
Chuck Martin,0.0,0,0,AC,Notre Dame,0,0,2012
Chuck Martin,0.0,0,0,assistant,Notre Dame,0,0,2012
Chuck Martin,0.0,0,0,assistant,Notre Dame,0,0,2011
Chuck Martin,0.0,0,0,assistant,Notre Dame,0,0,2010
Justin Wilcox,0.0,900000,0,coach,California,1600000,1600000,2017
Justin Wilcox,0.0,117000,0,assistant,Wisconsin,500000,500000,2016
Justin Wilcox,0.0,0,0,assistant,USC,0,0,2015
Justin Wilcox,0.0,0,0,AC,USC,0,0,2014
Justin Wilcox,0.0,0,0,assistant,USC,0,0,2014
Justin Wilcox,0.0,61000,0,assistant,Washington,800004,800004,2013
Justin Wilcox,0.0,61000,0,assistant,Washington,750004,750004,2012
Justin Wilcox,0.0,0,0,assistant,Tennessee,625000,625000,2011
Justin Wilcox,0.0,0,0,assistant,Tennessee,600000,600000,2010
Justin Wilcox,0.0,28351,34333,assistant,Boise State,190133,224466,2009
Dave Doeren,150000.0,1750000,0,coach,North Carolina State,2212600,2212600,2017
Dave Doeren,125000.0,1750000,0,coach,North Carolina State,2200000,2200000,2016
Dave Doeren,100000.0,1750000,0,coach,North Carolina State,2200000,2200000,2015
Dave Doeren,0.0,1000000,0,coach,North Carolina State,1800000,1800000,2014
Dave Doeren,0.0,1000000,5000,coach,North Carolina State,2550000,2555000,2013
Dave Doeren,0.0,205000,3000,coach,Northern Illinois,420000,423000,2012
Dave Doeren,0.0,205000,0,coach,Northern Illinois,371000,371000,2011
Dave Doeren,0.0,83055,626,assistant,Wisconsin,249979,250605,2010
Dave Doeren,0.0,83055,10804,assistant,Wisconsin,237300,248104,2009
Paul Johnson,425000.0,1050000,0,coach,Georgia Tech,2970891,2970891,2017
Paul Johnson,235000.0,1050000,2000,coach,Georgia Tech,2884361,2886361,2016
Paul Johnson,450000.0,1050000,2000,coach,Georgia Tech,2800000,2802000,2015
Paul Johnson,450000.0,1050000,2000,HC,Georgia Tech,2800000,2802000,2015
Paul Johnson,0.0,1275000,2500,coach,Georgia Tech,2588000,2590500,2014
Paul Johnson,0.0,1025000,2500,coach,Georgia Tech,2513000,2515500,2013
Paul Johnson,0.0,1025000,5000,coach,Georgia Tech,2440700,2445700,2012
Paul Johnson,0.0,1125000,0,coach,Georgia Tech,2369000,2369000,2011
Paul Johnson,0.0,1125000,0,coach,Georgia Tech,2300000,2300000,2010
Paul Johnson,0.0,1025000,1975000,coach,Georgia Tech,325000,2300000,2009
Paul Johnson,0.0,0,0,coach,Navy,1049311,1049311,2007
Paul Johnson,0.0,0,0,coach,Navy,1003309,1003309,2006
Jim Mora,95000.0,1065000,0,coach,UCLA,3550000,3550000,2017
Jim Mora,120000.0,1065000,0,coach,UCLA,3450000,3450000,2016
Jim Mora,145000.0,930000,0,coach,UCLA,3350000,3350000,2015
Jim Mora,0.0,930000,0,coach,UCLA,3250000,3250000,2014
Jim Mora,0.0,750000,0,coach,UCLA,2300000,2300000,2013
Jim Mora,0.0,750000,0,HC,UCLA,2300000,2300000,2013
Jim Mora,0.0,750000,0,coach,UCLA,1935000,1935000,2012
Jim Mora,0.0,750000,0,HC,UCLA,1935000,1935000,2012
Jeff Tedford,0.0,2765000,0,coach,Fresno State,1550000,1550000,2017
Jeff Tedford,0.0,255000,0,coach,California,2600000,2600000,2012
Jeff Tedford,0.0,255000,0,coach,California,2300000,2300000,2011
Jeff Tedford,0.0,265000,5000,coach,California,2300000,2305000,2010
Jeff Tedford,0.0,265000,5000,HC,California,2300000,2305000,2010
Jeff Tedford,0.0,265000,1582500,coach,California,1225000,2807500,2009
Jeff Tedford,0.0,400000,1580800,coach,California,225000,1805800,2007
Jeff Tedford,0.0,400000,1580800,HC,California,225000,1805800,2007
Jeff Tedford,0.0,350000,1337800,coach,California,167500,1505300,2006
Kyle Whittingham,330833.0,935000,0,coach,Utah,3687917,3687917,2017
Kyle Whittingham,334167.0,935000,0,coach,Utah,3650000,3650000,2016
Kyle Whittingham,195000.0,935000,0,coach,Utah,2600000,2600000,2015
Kyle Whittingham,195000.0,935000,0,HC,Utah,2600000,2600000,2015
Kyle Whittingham,0.0,740000,0,coach,Utah,2200000,2200000,2014
Kyle Whittingham,0.0,740000,0,HC,Utah,2200000,2200000,2014
Kyle Whittingham,0.0,740000,0,coach,Utah,2427100,2427100,2013
Kyle Whittingham,0.0,740000,0,coach,Utah,2000000,2000000,2012
Kyle Whittingham,0.0,740000,0,coach,Utah,1700000,1700000,2011
Kyle Whittingham,0.0,485000,0,coach,Utah,1175000,1175000,2010
Kyle Whittingham,0.0,485000,937500,coach,Utah,270000,1207500,2009
Kyle Whittingham,0.0,350000,467000,coach,Utah,211120,678120,2007
Kyle Whittingham,0.0,280000,467000,coach,Utah,205000,672000,2006
Kirk Ferentz,600000.0,2875000,0,coach,Iowa,4550000,4550000,2017
Kirk Ferentz,600000.0,2875000,0,HC,Iowa,4550000,4550000,2017
Kirk Ferentz,900000.0,2875000,0,coach,Iowa,4500000,4500000,2016
Kirk Ferentz,25000.0,2375000,0,coach,Iowa,4075000,4075000,2015
Kirk Ferentz,0.0,1750000,0,coach,Iowa,4075000,4075000,2014
Kirk Ferentz,0.0,1750000,0,coach,Iowa,3985000,3985000,2013
Kirk Ferentz,0.0,1750000,0,coach,Iowa,3835000,3835000,2012
Kirk Ferentz,0.0,1750000,0,coach,Iowa,3785000,3785000,2011
Kirk Ferentz,0.0,1750000,0,HC,Iowa,3785000,3785000,2011
Kirk Ferentz,0.0,1750000,6000,coach,Iowa,3775000,3781000,2010
Kirk Ferentz,0.0,1000000,4500,coach,Iowa,3020000,3024500,2009
Kirk Ferentz,0.0,1000000,10000,coach,Iowa,3020000,3030000,2007
Kirk Ferentz,0.0,1000000,10000,HC,Iowa,3020000,3030000,2007
Kirk Ferentz,0.0,1000000,0,coach,Iowa,2840000,2840000,2006
Jeff Brohm,0.0,1200000,0,coach,Purdue,3333333,3333333,2017
Jeff Brohm,150000.0,450000,3120,coach,Western Kentucky,805600,808720,2016
Jeff Brohm,100000.0,450000,3120,coach,Western Kentucky,610800,613920,2015
Jeff Brohm,0.0,550000,0,coach,Western Kentucky,600000,600000,2014
Jeff Brohm,0.0,25000,0,assistant,Western Kentucky,150000,150000,2013
Jeff Brohm,0.0,0,1200,assistant,UAB,170000,171200,2012
Jeff Brohm,0.0,24700,0,assistant,Illinois,190000,190000,2011
Jeff Brohm,0.0,22360,120,assistant,Illinois,172000,172120,2010
Jeff Brohm,0.0,0,0,assistant,Florida Atlantic,50000,50000,2009
Tyson Summers,0.0,292500,0,coach,Georgia Southern,530000,530000,2017
Tyson Summers,0.0,292500,0,coach,Georgia Southern,500000,500000,2016
Tyson Summers,0.0,55556,0,assistant,Colorado State,300000,300000,2015
Tyson Summers,0.0,15000,2700,assistant,UCF,180000,182700,2014
Tyson Summers,0.0,12500,2700,assistant,UCF,150000,152700,2013
Tyson Summers,0.0,11250,0,assistant,UCF,135000,135000,2012
Tyson Summers,0.0,0,1175,assistant,UAB,74528,75703,2011
Tyson Summers,0.0,11708,1175,assistant,UAB,70250,71425,2010
Tyson Summers,0.0,10500,1100,assistant,UAB,63000,64100,2009
Major Applewhite,0.0,782500,0,coach,Houston,1750000,1750000,2017
Major Applewhite,0.0,63750,0,assistant,Houston,375000,375000,2016
Major Applewhite,0.0,51170,0,AC,Houston,301000,301000,2015
Major Applewhite,0.0,51170,0,assistant,Houston,301000,301000,2015
Major Applewhite,0.0,123500,0,assistant,Texas,650000,650000,2013
Major Applewhite,0.0,110900,0,assistant,Texas,575000,575000,2012
Major Applewhite,0.0,104150,1000,assistant,Texas,500000,501000,2011
Major Applewhite,0.0,37910,0,assistant,Texas,269509,269509,2010
Major Applewhite,0.0,37050,15500,assistant,Texas,245000,260500,2009
Chris Creighton,35000.0,395000,0,coach,Eastern Michigan,442420,442420,2017
Chris Creighton,0.0,310000,0,coach,Eastern Michigan,434840,434840,2016
Chris Creighton,0.0,310000,0,HC,Eastern Michigan,434840,434840,2016
Chris Creighton,0.0,310000,0,coach,Eastern Michigan,425000,425000,2015
Chris Creighton,0.0,310000,0,coach,Eastern Michigan,425000,425000,2014
Jason Candle,57500.0,615000,950,coach,Toledo,700000,700950,2017
Jason Candle,0.0,602500,0,coach,Toledo,675000,675000,2016
Jason Candle,0.0,1500,450,assistant,Toledo,135762,136212,2015
Jason Candle,0.0,1500,450,assistant,Toledo,132600,133050,2014
Jason Candle,0.0,1500,450,assistant,Toledo,115000,115450,2013
Jason Candle,0.0,0,450,assistant,Toledo,115000,115450,2012
Jason Candle,0.0,1500,0,assistant,Toledo,63825,63825,2011
Jason Candle,0.0,0,0,assistant,Toledo,61200,61200,2010
Jason Candle,0.0,1500,0,AC,Toledo,60000,60000,2009
Jason Candle,0.0,1500,0,assistant,Toledo,60000,60000,2009
Bill Snyder,50000.0,580000,5000,coach,Kansas State,3200000,3205000,2017
Bill Snyder,50000.0,580000,6000,coach,Kansas State,3100000,3106000,2016
Bill Snyder,150000.0,580000,0,coach,Kansas State,3000000,3000000,2015
Bill Snyder,150000.0,580000,0,HC,Kansas State,3000000,3000000,2015
Bill Snyder,0.0,580000,0,coach,Kansas State,2900000,2900000,2014
Bill Snyder,0.0,580000,3000,coach,Kansas State,2800000,2803000,2013
Bill Snyder,0.0,580000,3000,HC,Kansas State,2800000,2803000,2013
Bill Snyder,0.0,455000,0,coach,Kansas State,2200000,2200000,2012
Bill Snyder,0.0,455000,0,HC,Kansas State,2200000,2200000,2012
Bill Snyder,0.0,455000,0,coach,Kansas State,1925000,1925000,2011
Bill Snyder,0.0,455000,0,coach,Kansas State,1875000,1875000,2010
Bill Snyder,0.0,455000,308333,coach,Kansas State,1541667,1850000,2009
Willie Fritz,0.0,0,0,coach,Tulane,0,0,2017
Willie Fritz,0.0,0,0,coach,Tulane,0,0,2016
Willie Fritz,35000.0,287500,0,coach,Georgia Southern,500000,500000,2015
Willie Fritz,35000.0,287500,0,HC,Georgia Southern,500000,500000,2015
Willie Fritz,0.0,42500,0,coach,Georgia Southern,400000,400000,2014
Lincoln Riley,0.0,700000,0,coach,Oklahoma,2116666,2116666,2017
Lincoln Riley,0.0,119000,5000,assistant,Oklahoma,900000,905000,2016
Lincoln Riley,0.0,70000,0,assistant,Oklahoma,500000,500000,2015
Lincoln Riley,0.0,0,3800,assistant,East Carolina,275000,278800,2014
Lincoln Riley,0.0,0,1725,assistant,East Carolina,200000,201725,2013
Lincoln Riley,0.0,0,1800,assistant,East Carolina,151800,153600,2012
Lincoln Riley,0.0,0,1725,assistant,East Carolina,150000,151725,2011
Lincoln Riley,0.0,150000,0,assistant,East Carolina,150000,150000,2010
Lincoln Riley,0.0,15833,7500,assistant,Texas Tech,190000,197500,2009
Kirby Smart,75000.0,1800000,0,coach,Georgia,3753600,3753600,2017
Kirby Smart,75000.0,1800000,0,HC,Georgia,3753600,3753600,2017
Kirby Smart,0.0,1800000,0,coach,Georgia,3753600,3753600,2016
Kirby Smart,0.0,250000,1500,assistant,Alabama,1500000,1501500,2015
Kirby Smart,0.0,250000,5850,assistant,Alabama,1350000,1355850,2014
Kirby Smart,0.0,230000,350,assistant,Alabama,1150000,1150350,2013
Kirby Smart,0.0,190000,0,assistant,Alabama,950000,950000,2012
Kirby Smart,0.0,170000,1500,assistant,Alabama,850000,851500,2011
Kirby Smart,0.0,150000,12350,assistant,Alabama,750000,762350,2010
Kirby Smart,0.0,72000,9350,assistant,Alabama,360000,369350,2009
Brent Brennan,0.0,210000,0,coach,San Jose State,581916,581916,2017
Brent Brennan,0.0,77777,0,AC,Oregon State,200004,200004,2016
Brent Brennan,0.0,77777,0,assistant,Oregon State,200004,200004,2016
Brent Brennan,0.0,74487,0,AC,Oregon State,180264,180264,2015
Brent Brennan,0.0,74487,0,assistant,Oregon State,180264,180264,2015
Brent Brennan,0.0,16667,0,AC,Oregon State,180264,180264,2014
Brent Brennan,0.0,16667,0,assistant,Oregon State,180264,180264,2014
Brent Brennan,0.0,16667,0,assistant,Oregon State,175008,175008,2013
Brent Brennan,0.0,16667,0,assistant,Oregon State,150000,150000,2012
Brent Brennan,0.0,16667,0,assistant,Oregon State,150000,150000,2011
Brent Brennan,0.0,0,100,assistant,San Jose State,83523,83623,2010
Brent Brennan,0.0,0,599,assistant,San Jose State,91116,91715,2009
Joe Moglia,0.0,525000,0,coach,Coastal Carolina,400000,400000,2017
Skip Holtz,50000.0,395000,4000,coach,Louisiana Tech,700000,704000,2017
Skip Holtz,25000.0,295000,15000,coach,Louisiana Tech,500000,515000,2016
Skip Holtz,25000.0,295000,17000,coach,Louisiana Tech,500000,517000,2015
Skip Holtz,0.0,295000,10000,coach,Louisiana Tech,500000,510000,2014
Skip Holtz,0.0,295000,10000,coach,Louisiana Tech,500000,510000,2013
Skip Holtz,0.0,295000,10000,HC,Louisiana Tech,500000,510000,2013
Skip Holtz,0.0,650000,0,coach,South Florida,2000000,2000000,2012
Skip Holtz,0.0,650000,0,HC,South Florida,2000000,2000000,2012
Skip Holtz,0.0,350000,0,coach,South Florida,1700000,1700000,2011
Skip Holtz,0.0,350000,0,coach,South Florida,1700000,1700000,2010
Skip Holtz,0.0,125000,435000,coach,East Carolina,947863,1382863,2009
Skip Holtz,0.0,125000,435000,HC,East Carolina,947863,1382863,2009
Skip Holtz,0.0,125000,350000,coach,East Carolina,210060,560060,2007
Skip Holtz,0.0,75000,275000,coach,East Carolina,150000,425000,2006
Sean Kugler,24611.0,493776,0,coach,UTEP,515332,515332,2017
Sean Kugler,24128.0,493776,0,coach,UTEP,515332,515332,2016
Sean Kugler,75044.0,486052,4500,coach,UTEP,509541,514041,2015
Sean Kugler,0.0,478481,4500,coach,UTEP,503864,508364,2014
Sean Kugler,0.0,449999,0,coach,UTEP,500000,500000,2013
Everett Withers,0.0,68750,0,coach,Texas State,675000,675000,2017
Everett Withers,0.0,68750,0,HC,Texas State,675000,675000,2017
Everett Withers,0.0,66667,0,coach,Texas State,650000,650000,2016
Everett Withers,0.0,217500,0,assistant,Ohio State,585000,585000,2013
Everett Withers,0.0,112500,0,assistant,Ohio State,456000,456000,2012
Everett Withers,0.0,100000,0,coach,North Carolina,500000,500000,2011
Everett Withers,0.0,100000,0,HC,North Carolina,500000,500000,2011
Everett Withers,0.0,55000,0,assistant,North Carolina,330000,330000,2010
Everett Withers,0.0,55000,0,assistant,North Carolina,330000,330000,2009
Gary Patterson,0.0,0,0,coach,TCU,5104077,5104077,2017
Gary Patterson,0.0,0,0,coach,TCU,4014723,4014723,2016
Gary Patterson,0.0,0,0,coach,TCU,3940026,3940026,2015
Gary Patterson,0.0,0,0,coach,TCU,4008150,4008150,2014
Gary Patterson,0.0,0,0,HC,TCU,4008150,4008150,2014
Gary Patterson,0.0,0,0,coach,TCU,3120760,3120760,2013
Gary Patterson,0.0,0,0,coach,TCU,3467926,3467926,2012
Gary Patterson,0.0,0,0,coach,TCU,2018362,2018362,2011
Gary Patterson,0.0,0,0,coach,TCU,1642089,1642089,2010
Gary Patterson,0.0,0,0,coach,TCU,1800000,1800000,2009
Gary Patterson,0.0,0,0,HC,TCU,1800000,1800000,2009
Gary Patterson,0.0,0,0,coach,TCU,1219212,1219212,2007
Gary Patterson,0.0,0,0,coach,TCU,952162,952162,2006
Ed Orgeron,25000.0,1575000,0,coach,LSU,3500000,3500000,2017
Ed Orgeron,0.0,75000,11000,assistant,LSU,610000,621000,2016
Ed Orgeron,0.0,75000,0,assistant,LSU,465000,465000,2015
Ed Orgeron,0.0,0,0,assistant,USC,0,0,2013
Ed Orgeron,0.0,0,0,AC,USC,0,0,2012
Ed Orgeron,0.0,0,0,assistant,USC,0,0,2012
Ed Orgeron,0.0,0,0,assistant,USC,0,0,2011
Ed Orgeron,0.0,0,0,assistant,USC,0,0,2010
Ed Orgeron,0.0,50000,375000,assistant,Tennessee,275000,650000,2009
Ed Orgeron,0.0,0,700000,coach,Ole Miss,200000,900000,2007
Ed Orgeron,0.0,0,5000,coach,Ole Miss,900000,905000,2006
Dabo Swinney,1525000.0,1000000,22200,coach,Clemson,8504600,8526800,2017
Dabo Swinney,1100000.0,1725000,5200,coach,Clemson,4417500,4422700,2016
Dabo Swinney,50000.0,1125000,5200,coach,Clemson,3300000,3305200,2015
Dabo Swinney,0.0,1200000,25100,coach,Clemson,3150000,3175100,2014
Dabo Swinney,0.0,775000,10000,coach,Clemson,2540024,2550024,2013
Dabo Swinney,0.0,775000,10000,coach,Clemson,2040024,2050024,2012
Dabo Swinney,0.0,775000,13000,coach,Clemson,1833333,1846333,2011
Dabo Swinney,0.0,775000,13000,HC,Clemson,1833333,1846333,2011
Dabo Swinney,0.0,694792,18500,coach,Clemson,1750000,1768500,2010
Dabo Swinney,0.0,875000,566850,coach,Clemson,250000,816850,2009
Mike Riley,150000.0,950000,0,coach,Nebraska,2900000,2900000,2017
Mike Riley,0.0,950000,0,coach,Nebraska,2800000,2800000,2016
Mike Riley,0.0,950000,0,coach,Nebraska,2700000,2700000,2015
Mike Riley,0.0,369000,0,coach,Oregon State,1510008,1510008,2014
Mike Riley,0.0,369000,0,HC,Oregon State,1510008,1510008,2014
Mike Riley,0.0,360000,0,coach,Oregon State,1417843,1417843,2013
Mike Riley,0.0,360000,0,HC,Oregon State,1417843,1417843,2013
Mike Riley,0.0,360000,0,coach,Oregon State,1317847,1317847,2012
Mike Riley,0.0,360000,0,coach,Oregon State,1313471,1313471,2011
Mike Riley,0.0,360000,0,HC,Oregon State,1313471,1313471,2011
Mike Riley,0.0,360000,0,coach,Oregon State,1110000,1110000,2010
Mike Riley,0.0,395000,425000,coach,Oregon State,525000,950000,2009
Mike Riley,0.0,360000,425000,coach,Oregon State,460000,885000,2007
Mike Riley,0.0,295000,425000,coach,Oregon State,410000,835000,2006
Mike Riley,0.0,295000,425000,HC,Oregon State,410000,835000,2006
Jim McElwain,300000.0,925000,0,coach,Florida,4457400,4457400,2017
Jim McElwain,300000.0,925000,0,HC,Florida,4457400,4457400,2017
Jim McElwain,100000.0,450000,0,coach,Florida,4268325,4268325,2016
Jim McElwain,0.0,450000,0,coach,Florida,3983359,3983359,2015
Jim McElwain,0.0,150000,0,coach,Colorado State,1500000,1500000,2014
Jim McElwain,0.0,150000,0,HC,Colorado State,1500000,1500000,2014
Jim McElwain,0.0,150000,0,coach,Colorado State,1350000,1350000,2013
Jim McElwain,0.0,150000,0,HC,Colorado State,1350000,1350000,2013
Jim McElwain,0.0,150000,0,coach,Colorado State,1350000,1350000,2012
Jim McElwain,0.0,102000,6000,AC,Alabama,510000,516000,2011
Jim McElwain,0.0,102000,6000,assistant,Alabama,510000,516000,2011
Jim McElwain,0.0,82000,6500,assistant,Alabama,410000,416500,2010
Jim McElwain,0.0,72000,150,assistant,Alabama,360000,360150,2009
Matt Campbell,0.0,1000000,0,coach,Iowa State,2100000,2100000,2017
Matt Campbell,0.0,900000,0,coach,Iowa State,2000000,2000000,2016
Matt Campbell,0.0,900000,0,HC,Iowa State,2000000,2000000,2016
Matt Campbell,137500.0,450000,1450,coach,Toledo,495000,496450,2015
Matt Campbell,0.0,450000,12037,coach,Toledo,470500,482537,2014
Matt Campbell,0.0,400000,2500,coach,Toledo,455000,457500,2013
Matt Campbell,0.0,305000,450,coach,Toledo,360000,360450,2012
Matt Campbell,0.0,305000,450,HC,Toledo,360000,360450,2012
Matt Campbell,0.0,1500,0,assistant,Toledo,120000,120000,2011
Matt Campbell,0.0,0,0,AC,Toledo,120000,120000,2010
Matt Campbell,0.0,0,0,assistant,Toledo,120000,120000,2010
Matt Campbell,0.0,1500,0,assistant,Toledo,120000,120000,2009
Dan Mullen,150000.0,1150000,0,coach,Mississippi State,4500000,4500000,2017
Dan Mullen,200000.0,900000,0,coach,Mississippi State,4200000,4200000,2016
Dan Mullen,200000.0,900000,0,HC,Mississippi State,4200000,4200000,2016
Dan Mullen,390000.0,900000,0,coach,Mississippi State,4000000,4000000,2015
Dan Mullen,0.0,710000,0,coach,Mississippi State,3000000,3000000,2014
Dan Mullen,0.0,650000,0,coach,Mississippi State,2700000,2700000,2013
Dan Mullen,0.0,650000,0,coach,Mississippi State,2600000,2600000,2012
Dan Mullen,0.0,650000,0,coach,Mississippi State,2500000,2500000,2011
Dan Mullen,0.0,0,8295,coach,Mississippi State,1200000,1208295,2010
Dan Mullen,0.0,0,8295,HC,Mississippi State,1200000,1208295,2010
Dan Mullen,0.0,100000,950000,coach,Mississippi State,250000,1200000,2009
Dan Mullen,0.0,100000,950000,HC,Mississippi State,250000,1200000,2009
Philip Montgomery,0.0,0,0,coach,Tulsa,1398038,1398038,2017
Philip Montgomery,0.0,0,0,coach,Tulsa,0,0,2016
Philip Montgomery,0.0,0,0,HC,Tulsa,0,0,2016
Philip Montgomery,0.0,0,0,coach,Tulsa,0,0,2015
Philip Montgomery,0.0,0,0,HC,Tulsa,0,0,2015
Philip Montgomery,0.0,0,0,assistant,Baylor,504645,504645,2014
Philip Montgomery,0.0,0,0,assistant,Baylor,0,0,2013
Philip Montgomery,0.0,0,0,assistant,Baylor,0,0,2012
Philip Montgomery,0.0,0,0,assistant,Baylor,0,0,2011
Philip Montgomery,0.0,0,0,AC,Baylor,0,0,2010
Philip Montgomery,0.0,0,0,assistant,Baylor,0,0,2010
Philip Montgomery,0.0,0,0,AC,Baylor,0,0,2009
Philip Montgomery,0.0,0,0,assistant,Baylor,0,0,2009
Scottie Montgomery,75000.0,850000,0,coach,East Carolina,1050000,1050000,2017
Scottie Montgomery,0.0,850000,0,coach,East Carolina,1000000,1000000,2016
Scottie Montgomery,0.0,0,0,AC,Duke,0,0,2015
Scottie Montgomery,0.0,0,0,assistant,Duke,0,0,2015
Scottie Montgomery,0.0,0,0,assistant,Duke,0,0,2014
Scottie Montgomery,0.0,0,0,assistant,Duke,0,0,2013
Scottie Montgomery,0.0,0,0,assistant,Duke,0,0,2009
James Franklin,900000.0,1000000,0,coach,Penn State,4600000,4600000,2017
James Franklin,200000.0,1000000,0,coach,Penn State,4500000,4500000,2016
James Franklin,200000.0,1000000,0,coach,Penn State,4400000,4400000,2015
James Franklin,0.0,1000000,0,coach,Penn State,4300000,4300000,2014
James Franklin,0.0,0,0,coach,Vanderbilt,1842771,1842771,2013
James Franklin,0.0,0,0,coach,Vanderbilt,0,0,2012
James Franklin,0.0,0,0,coach,Vanderbilt,0,0,2011
James Franklin,0.0,160000,0,assistant,Maryland,486500,486500,2010
James Franklin,0.0,160000,165000,assistant,Maryland,303954,468954,2009
Rocky Long,198150.0,735000,2000,coach,San Diego State,826304,828304,2017
Rocky Long,198150.0,735000,2000,HC,San Diego State,826304,828304,2017
Rocky Long,195000.0,655000,0,coach,San Diego State,810632,810632,2016
Rocky Long,195000.0,655000,0,HC,San Diego State,810632,810632,2016
Rocky Long,65000.0,655000,2000,coach,San Diego State,806300,808300,2015
Rocky Long,0.0,855000,2000,coach,San Diego State,800000,802000,2014
Rocky Long,0.0,855000,0,coach,San Diego State,800000,800000,2013
Rocky Long,0.0,805000,2600,coach,San Diego State,800000,802600,2012
Rocky Long,0.0,805000,2600,HC,San Diego State,800000,802600,2012
Rocky Long,0.0,855000,1000,coach,San Diego State,800000,801000,2011
Rocky Long,0.0,855000,1000,HC,San Diego State,800000,801000,2011
Rocky Long,0.0,0,0,assistant,San Diego State,205008,205008,2010
Rocky Long,0.0,64554,0,assistant,San Diego State,205008,205008,2009
Rocky Long,0.0,0,75000,coach,New Mexico,364513,439513,2007
Rocky Long,0.0,0,75000,HC,New Mexico,364513,439513,2007
Rocky Long,0.0,0,75000,coach,New Mexico,356175,431175,2006
Charlie Strong,0.0,815000,0,coach,South Florida,1000000,1000000,2017
Charlie Strong,0.0,815000,0,HC,South Florida,1000000,1000000,2017
Charlie Strong,0.0,1006000,130,coach,Texas,5200000,5200130,2016
Charlie Strong,0.0,1006000,130,HC,Texas,5200000,5200130,2016
Charlie Strong,25000.0,1003000,270,coach,Texas,5100000,5100270,2015
Charlie Strong,0.0,1000000,270,coach,Texas,5000000,5000270,2014
Charlie Strong,0.0,1000000,270,HC,Texas,5000000,5000270,2014
Charlie Strong,0.0,808333,38500,coach,Louisville,3700000,3738500,2013
Charlie Strong,0.0,808333,38500,HC,Louisville,3700000,3738500,2013
Charlie Strong,0.0,691666,5000,coach,Louisville,2300000,2305000,2012
Charlie Strong,0.0,500000,5000,coach,Louisville,2300000,2305000,2011
Charlie Strong,0.0,633333,0,coach,Louisville,1600000,1600000,2010
Charlie Strong,0.0,0,10000,assistant,Florida,300000,310000,2009
Butch Jones,250000.0,1000000,0,coach,Tennessee,4110000,4110000,2017
Butch Jones,350000.0,1000000,0,coach,Tennessee,4110000,4110000,2016
Butch Jones,300000.0,1000000,23000,coach,Tennessee,3610000,3633000,2015
Butch Jones,0.0,1000000,0,coach,Tennessee,2960000,2960000,2014
Butch Jones,0.0,1000000,0,coach,Tennessee,4860000,4860000,2013
Butch Jones,0.0,330000,0,coach,Cincinnati,1769648,1769648,2012
Butch Jones,0.0,330000,500,coach,Cincinnati,1393333,1393833,2011
Butch Jones,0.0,330000,500,HC,Cincinnati,1393333,1393833,2011
Butch Jones,0.0,320000,1500,coach,Cincinnati,1100000,1101500,2010
Butch Jones,0.0,320000,1500,HC,Cincinnati,1100000,1101500,2010
Butch Jones,0.0,237500,30500,coach,Central Michigan,277950,308450,2009
Butch Jones,0.0,140000,65000,coach,Central Michigan,200850,265850,2007
Frank Wilson,17500.0,185000,0,coach,UTSA,1137500,1137500,2017
Frank Wilson,17500.0,185000,0,HC,UTSA,1137500,1137500,2017
Frank Wilson,0.0,185000,0,coach,UTSA,835000,835000,2016
Frank Wilson,0.0,75000,16067,assistant,LSU,660000,676067,2015
Frank Wilson,0.0,70000,15967,AC,LSU,650000,665967,2014
Frank Wilson,0.0,70000,15967,assistant,LSU,650000,665967,2014
Frank Wilson,0.0,70000,16667,assistant,LSU,600000,616667,2013
Frank Wilson,0.0,70000,11667,assistant,LSU,550000,561667,2012
Frank Wilson,0.0,70000,11667,assistant,LSU,335000,346667,2011
Frank Wilson,0.0,70000,0,AC,LSU,335000,335000,2010
Frank Wilson,0.0,70000,0,assistant,LSU,335000,335000,2010
Frank Wilson,0.0,0,0,assistant,Tennessee,150000,150000,2009
Rod Carey,17500.0,205000,0,coach,Northern Illinois,623000,623000,2017
Rod Carey,52500.0,205000,2500,coach,Northern Illinois,623000,625500,2016
Rod Carey,77500.0,205000,1500,coach,Northern Illinois,400000,401500,2015
Rod Carey,0.0,205000,1500,coach,Northern Illinois,400000,401500,2014
Rod Carey,0.0,205000,1000,coach,Northern Illinois,375000,376000,2013
Rod Carey,0.0,11667,0,AC,Northern Illinois,88002,88002,2012
Rod Carey,0.0,11667,0,assistant,Northern Illinois,88002,88002,2012
Rod Carey,0.0,11667,0,assistant,Northern Illinois,80004,80004,2011
Dino Babers,0.0,0,0,coach,Syracuse,0,0,2017
Dino Babers,0.0,0,0,coach,Syracuse,0,0,2016
Dino Babers,107500.0,245000,0,coach,Bowling Green,413000,413000,2015
Dino Babers,0.0,130000,0,coach,Bowling Green,405000,405000,2014
Dino Babers,0.0,0,0,assistant,Baylor,0,0,2011
Dino Babers,0.0,0,0,assistant,Baylor,0,0,2010
Dino Babers,0.0,0,0,assistant,Baylor,0,0,2009
Doc Holliday,25000.0,145000,0,coach,Marshall,762570,762570,2017
Doc Holliday,55000.0,145000,2750,coach,Marshall,762570,765320,2016
Doc Holliday,55000.0,145000,2750,HC,Marshall,762570,765320,2016
Doc Holliday,95000.0,145000,2750,coach,Marshall,755500,758250,2015
Doc Holliday,95000.0,145000,2750,HC,Marshall,755500,758250,2015
Doc Holliday,0.0,115000,2750,coach,Marshall,607070,609820,2014
Doc Holliday,0.0,80000,14250,coach,Marshall,607070,621320,2013
Doc Holliday,0.0,80000,14250,HC,Marshall,607070,621320,2013
Doc Holliday,0.0,80000,12750,coach,Marshall,600000,612750,2012
Doc Holliday,0.0,80000,12750,HC,Marshall,600000,612750,2012
Doc Holliday,0.0,80000,12750,coach,Marshall,607070,619820,2011
Doc Holliday,0.0,80000,17750,coach,Marshall,600000,617750,2010
Doc Holliday,0.0,30000,6000,AC,West Virginia,400000,406000,2009
Doc Holliday,0.0,30000,6000,assistant,West Virginia,400000,406000,2009
Mike Leach,75000.0,725000,0,coach,Washington State,3075000,3075000,2017
Mike Leach,100000.0,725000,0,coach,Washington State,2950000,2950000,2016
Mike Leach,0.0,625000,0,coach,Washington State,2750000,2750000,2015
Mike Leach,0.0,625000,0,coach,Washington State,2750000,2750000,2014
Mike Leach,0.0,625000,0,coach,Washington State,2250000,2250000,2013
Mike Leach,0.0,640000,0,coach,Washington State,2250000,2250000,2012
Mike Leach,0.0,650000,1600000,coach,Texas Tech,1100000,2700000,2009
Mike Leach,0.0,325000,1361500,coach,Texas Tech,300000,1661500,2007
Mike Leach,0.0,375000,1300000,coach,Texas Tech,300000,1600000,2006
Pat Fitzgerald,0.0,0,0,coach,Northwestern,3305818,3305818,2017
Pat Fitzgerald,0.0,0,0,coach,Northwestern,3350638,3350638,2016
Pat Fitzgerald,0.0,0,0,coach,Northwestern,2490858,2490858,2015
Pat Fitzgerald,0.0,0,0,HC,Northwestern,2490858,2490858,2015
Pat Fitzgerald,0.0,0,0,coach,Northwestern,2480967,2480967,2014
Pat Fitzgerald,0.0,0,0,coach,Northwestern,2221153,2221153,2013
Pat Fitzgerald,0.0,0,0,coach,Northwestern,1280751,1280751,2012
Pat Fitzgerald,0.0,0,0,coach,Northwestern,1189961,1189961,2011
Pat Fitzgerald,0.0,0,0,coach,Northwestern,0,0,2010
Pat Fitzgerald,0.0,0,0,coach,Northwestern,0,0,2009
Pat Fitzgerald,0.0,0,0,coach,Northwestern,0,0,2007
Pat Fitzgerald,0.0,0,0,coach,Northwestern,0,0,2006
Lance Leipold,0.0,380000,0,coach,Buffalo,405500,405500,2017
Lance Leipold,0.0,380000,0,coach,Buffalo,405500,405500,2016
Lance Leipold,0.0,380000,0,coach,Buffalo,400000,400000,2015
Nick Rolovich,60000.0,1260000,2094,coach,Hawaii,400008,402102,2017
Nick Rolovich,0.0,1260000,0,coach,Hawaii,400008,400008,2016
Nick Rolovich,0.0,7292,0,assistant,Nevada,175000,175000,2015
Nick Rolovich,0.0,0,500,assistant,Nevada,150590,151090,2014
Nick Rolovich,0.0,0,0,assistant,Nevada,125975,125975,2013
Nick Rolovich,0.0,0,0,assistant,Nevada,125975,125975,2012
Nick Rolovich,0.0,0,0,assistant,Hawaii,0,0,2011
Nick Rolovich,0.0,0,0,assistant,Hawaii,0,0,2010
Nick Rolovich,0.0,0,0,assistant,Hawaii,0,0,2009
Mike Bobo,50000.0,785000,0,coach,Colorado State,1550000,1550000,2017
Mike Bobo,50000.0,685000,0,coach,Colorado State,1450000,1450000,2016
Mike Bobo,50000.0,685000,0,HC,Colorado State,1450000,1450000,2016
Mike Bobo,0.0,685000,0,coach,Colorado State,1350000,1350000,2015
Mike Bobo,0.0,210000,3700,assistant,Georgia,575000,578700,2014
Mike Bobo,0.0,0,0,assistant,Georgia,585000,585000,2013
Mike Bobo,0.0,0,0,assistant,Georgia,335000,335000,2012
Mike Bobo,0.0,0,8900,assistant,Georgia,325000,333900,2011
Mike Bobo,0.0,92150,11000,assistant,Georgia,325000,336000,2010
Mike Bobo,0.0,92150,1600,assistant,Georgia,325000,326600,2009
Lane Kiffin,0.0,350000,0,coach,Florida Atlantic,950000,950000,2017
Lane Kiffin,0.0,306000,0,assistant,Alabama,1400000,1400000,2016
Lane Kiffin,0.0,149600,0,assistant,Alabama,680000,680000,2015
Lane Kiffin,0.0,149600,0,assistant,Alabama,680000,680000,2014
Lane Kiffin,0.0,0,0,coach,USC,2594091,2594091,2013
Lane Kiffin,0.0,0,0,coach,USC,2406505,2406505,2012
Lane Kiffin,0.0,0,0,coach,USC,0,0,2011
Lane Kiffin,0.0,0,0,HC,USC,0,0,2011
Lane Kiffin,0.0,0,0,coach,USC,0,0,2010
Lane Kiffin,0.0,540000,1650000,coach,Tennessee,350000,2000000,2009
Mike Neu,0.0,370000,5000,coach,Ball State,431375,436375,2017
Mike Neu,0.0,370000,3500,coach,Ball State,425000,428500,2016
Mike Neu,0.0,0,0,assistant,Tulane,0,0,2013
Mike Neu,0.0,0,0,assistant,Tulane,0,0,2012
Chris Ash,50000.0,960000,0,coach,Rutgers,2100000,2100000,2017
Chris Ash,50000.0,960000,0,HC,Rutgers,2100000,2100000,2017
Chris Ash,0.0,960000,0,coach,Rutgers,2000000,2000000,2016
Chris Ash,0.0,221850,0,assistant,Ohio State,580000,580000,2015
Chris Ash,0.0,195000,0,assistant,Ohio State,590000,590000,2014
Chris Ash,0.0,45833,0,assistant,Arkansas,550000,550000,2013
Chris Ash,0.0,92750,2050,AC,Wisconsin,265000,267050,2012
Chris Ash,0.0,92750,2050,assistant,Wisconsin,265000,267050,2012
Chris Ash,0.0,63000,1600,assistant,Wisconsin,210000,211600,2011
Chris Ash,0.0,57230,0,assistant,Wisconsin,163600,163600,2010
Chris Ash,0.0,22500,0,assistant,Iowa State,150000,150000,2009
John Bonamego,35500.0,330000,0,coach,Central Michigan,545640,545640,2017
John Bonamego,43500.0,320000,300,coach,Central Michigan,545640,545940,2016
John Bonamego,0.0,330000,0,coach,Central Michigan,533500,533500,2015
Matt Luke,0.0,0,0,coach,Ole Miss,1160000,1160000,2017
Matt Luke,0.0,67800,300,assistant,Ole Miss,565000,565300,2016
Matt Luke,0.0,55800,200,assistant,Ole Miss,465000,465200,2015
Matt Luke,0.0,0,200,assistant,Ole Miss,335000,335200,2014
Matt Luke,0.0,0,10000,AC,Ole Miss,300000,310000,2013
Matt Luke,0.0,0,10000,assistant,Ole Miss,300000,310000,2013
Matt Luke,0.0,22800,0,assistant,Ole Miss,285000,285000,2012
Matt Luke,0.0,0,0,assistant,Duke,0,0,2011
Matt Luke,0.0,0,0,assistant,Duke,0,0,2010
Matt Luke,0.0,0,0,assistant,Duke,0,0,2009
Gus Malzahn,275000.0,1400000,1960,coach,Auburn,4725000,4726960,2017
Gus Malzahn,125000.0,1400000,4500,coach,Auburn,4725000,4729500,2016
Gus Malzahn,125000.0,1400000,4500,coach,Auburn,4100000,4104500,2015
Gus Malzahn,0.0,1400000,4500,coach,Auburn,3850000,3854500,2014
Gus Malzahn,0.0,1250000,0,coach,Auburn,2440000,2440000,2013
Gus Malzahn,0.0,160000,3400,coach,Arkansas State,856210,859610,2012
Gus Malzahn,0.0,365000,9600,AC,Auburn,1300000,1309600,2011
Gus Malzahn,0.0,365000,9600,assistant,Auburn,1300000,1309600,2011
Gus Malzahn,0.0,165000,0,assistant,Auburn,500000,500000,2010
Gus Malzahn,0.0,112500,0,assistant,Auburn,350000,350000,2009
Jay Hopson,15000.0,867500,0,coach,Southern Miss,500000,500000,2017
Jay Hopson,0.0,867500,0,coach,Southern Miss,500000,500000,2016
Jay Hopson,0.0,15417,0,AC,Memphis,185000,185000,2010
Jay Hopson,0.0,15417,0,assistant,Memphis,185000,185000,2010
Jay Hopson,0.0,0,8800,assistant,Michigan,175100,183900,2009
David Cutcliffe,0.0,0,0,coach,Duke,2613638,2613638,2017
David Cutcliffe,0.0,0,0,coach,Duke,2320773,2320773,2016
David Cutcliffe,0.0,0,0,coach,Duke,2049055,2049055,2015
David Cutcliffe,0.0,0,0,HC,Duke,2049055,2049055,2015
David Cutcliffe,0.0,0,0,coach,Duke,1840341,1840341,2014
David Cutcliffe,0.0,0,0,coach,Duke,1792285,1792285,2013
David Cutcliffe,0.0,0,0,coach,Duke,1788523,1788523,2012
David Cutcliffe,0.0,0,0,coach,Duke,1762895,1762895,2011
David Cutcliffe,0.0,0,0,coach,Duke,1581903,1581903,2010
David Cutcliffe,0.0,0,0,HC,Duke,1581903,1581903,2010
David Cutcliffe,0.0,0,0,coach,Duke,0,0,2009
David Bailiff,0.0,0,0,coach,Rice,772883,772883,2017
David Bailiff,0.0,0,0,coach,Rice,903556,903556,2016
David Bailiff,0.0,0,0,coach,Rice,805088,805088,2015
David Bailiff,0.0,0,0,HC,Rice,805088,805088,2015
David Bailiff,0.0,0,0,coach,Rice,780243,780243,2014
David Bailiff,0.0,0,0,coach,Rice,646386,646386,2013
David Bailiff,0.0,0,0,coach,Rice,608846,608846,2012
David Bailiff,0.0,0,0,coach,Rice,625001,625001,2011
David Bailiff,0.0,0,0,HC,Rice,625001,625001,2011
David Bailiff,0.0,0,0,coach,Rice,487340,487340,2010
David Bailiff,0.0,0,0,coach,Rice,476842,476842,2009
David Bailiff,0.0,0,0,coach,Rice,0,0,2007
Butch Davis,0.0,550000,0,coach,Florida International,900000,900000,2017
Butch Davis,0.0,550000,0,HC,Florida International,900000,900000,2017
Butch Davis,0.0,105000,0,coach,North Carolina,1752000,1752000,2010
Butch Davis,0.0,105000,0,coach,North Carolina,1702000,1702000,2009
Butch Davis,0.0,95333,499000,coach,North Carolina,1411000,1910000,2007
Paul Haynes,1000.0,173000,0,coach,Kent State,414030,414030,2017
Paul Haynes,12000.0,173000,1000,coach,Kent State,405912,406912,2016
Paul Haynes,1000.0,173000,2200,coach,Kent State,390150,392350,2015
Paul Haynes,0.0,336000,1200,coach,Kent State,382500,383700,2014
Paul Haynes,0.0,336000,1200,HC,Kent State,382500,383700,2014
Paul Haynes,0.0,261000,0,coach,Kent State,382500,382500,2013
Paul Haynes,0.0,141667,0,AC,Arkansas,425000,425000,2012
Paul Haynes,0.0,141667,0,assistant,Arkansas,425000,425000,2012
Paul Haynes,0.0,68750,0,AC,Ohio State,275000,275000,2011
Paul Haynes,0.0,68750,0,assistant,Ohio State,275000,275000,2011
Paul Haynes,0.0,39167,0,assistant,Ohio State,235000,235000,2010
Paul Haynes,0.0,31500,600,assistant,Ohio State,189000,189600,2009
